政	まつりごと, まん, セイ, ショウ	politics, government
議	ギ	deliberation, consultation, debate, consideration
連	つら.なる, つら.ねる, つ.れる, -づ.れ, レン	take along, lead, join, connect, party, gang, clique
対	あいて, こた.える, そろ.い, つれあ.い, なら.ぶ, むか.う, タイ, ツイ	vis-a-vis, opposite, even, equal, versus, anti-, compare
部	-べ, ブ	section, bureau, dept, class, copy, part, portion, counter for copies of a newspaper or magazine
党	なかま, むら, トウ	party, faction, clique
内	うち, ナイ, ダイ	inside, within, between, among, house, home
相	あい-, ソウ, ショウ	inter-, mutual, together, each other, minister of state, councillor, aspect, phase, physiognomy
定	さだ.める, さだ.まる, さだ.か, テイ, ジョウ	determine, fix, establish, decide
選	えら.ぶ, セン	elect, select, choose, prefer
米	こめ, よね, ベイ, マイ, メエトル	rice, USA, metre
実	み, みの.る, まこと, まことに, みの, みち.る, ジツ, シツ	reality, truth
関	せき, -ぜき, かか.わる, からくり, かんぬき, カン	connection, barrier, gateway, involve, concerning
決	き.める, -ぎ.め, き.まる, さ.く, ケツ	decide, fix, agree upon, appoint
全	まった.く, すべ.て, ゼン	whole, entire, all, complete, fulfill
表	おもて, -おもて, あらわ.す, あらわ.れる, あら.わす, ヒョウ	surface, table, chart, diagram
戦	いくさ, たたか.う, おのの.く, そよ.ぐ, わなな.く, セン	war, battle, match
経	へ.る, た.つ, たていと, はか.る, のり, ケイ, キョウ	sutra, longitude, pass thru, expire, warp
最	もっと.も, つま, サイ, シュ	utmost, most, extreme
現	あらわ.れる, あらわ.す, うつつ, うつ.つ, ゲン	present, existing, actual
調	しら.べる, しら.べ, ととの.う, ととの.える, チョウ	tune, tone, meter, key (music), writing style, prepare, exorcise, investigate, harmonize, mediate
化	ば.ける, ば.かす, ふ.ける, け.する, カ, ケ	change, take the form of, influence, enchant, delude, -ization
当	あ.たる, あ.たり, あ.てる, あ.て, まさ.に, まさ.にべし, トウ	hit, right, appropriate, himself
約	つづ.まる, つづ.める, つづま.やか, ヤク	promise, approximately, shrink
法	のり, ホウ, ハッ, ホッ, フラン	method, law, rule, principle, model, system
性	さが, セイ, ショウ	sex, gender, nature
的	まと, テキ	bull's eye, mark, target, object, adjective ending
要	い.る, かなめ, ヨウ	need, main point, essence, pivot, key to
制	セイ	system, law, rule
治	おさ.める, おさ.まる, なお.る, なお.す, ジ, チ	reign, be at peace, calm down, subdue, quell, govt, cure, heal, rule, conserve
務	つと.める, ム	task, duties
成	な.る, な.す, -な.す, セイ, ジョウ	turn into, become, get, grow, elapse, reach
期	キ, ゴ	period, time, date, term
公	おおやけ, コウ, ク	public, prince, official, governmental
協	キョウ	co-, cooperation
取	と.る, と.り, と.り-, とり, -ど.り, シュ	take, fetch, take up
和	やわ.らぐ, やわ.らげる, なご.む, なご.やか, ワ, オ, カ	harmony, Japanese style, peace, soften, Japan
機	はた, キ	loom, mechanism, machine, airplane, opportunity, potency, efficacy, occasion
平	たい.ら, -だいら, ひら, ひら-, ヘイ, ビョウ, ヒョウ	even, flat, peace
総	す.べて, すべ.て, ふさ, ソウ	general, whole, all, full, total
加	くわ.える, くわ.わる, カ	add, addition, increase, join, include, Canada
受	う.ける, -う.け, う.かる, ジュ	accept, undergo, answer (phone), take, get, catch, receive
領	えり, リョウ	jurisdiction, dominion, territory, fief, reign
続	つづ.く, つづ.ける, つぐ.ない, ゾク, ショク, コウ, キョウ	continue, series, sequel
設	もう.ける, セツ	establishment, provision, prepare
保	たも.つ, ホ, ホウ	protect, guarantee, keep, preserve, sustain, support
改	あらた.める, あらた.まる, カイ	reformation, change, modify, mend, renew, examine, inspect, search
数	かず, かぞ.える, しばしば, せ.める, わずらわ.しい, スウ, ス, サク, ソク, シュ	number, strength, fate, law, figures
記	しる.す, キ	scribe, account, narrative
初	はじ.め, はじ.めて, はつ, はつ-, うい-, -そ.める, -ぞ.め, ショ	first time, beginning
指	ゆび, さ.す, -さ.し, シ	finger, point to, indicate, put into, play (chess), measure (ruler)
権	おもり, かり, はか.る, ケン, ゴン	authority, power, rights
支	ささ.える, つか.える, か.う, シ	branch, support, sustain, branch radical (no. 65)
第	ダイ, テイ	No., residence
結	むす.ぶ, ゆ.う, ゆ.わえる, ケツ, ケチ	tie, bind, contract, join, organize, do up hair, fasten
点	つ.ける, つ.く, た.てる, さ.す, とぼ.す, とも.す, ぼち, テン	spot, point, mark, speck, decimal point
報	むく.いる, ホウ	report, news, reward, retribution
済	す.む, -ず.み, -ずみ, す.まない, す.ます, -す.ます, すく.う, な.す, わたし, わた.る, サイ, セイ	finish, come to an end, excusable, need not
府	フ	borough, urban prefecture, govt office, representative body, storehouse
活	い.きる, い.かす, い.ける, カツ	lively, resuscitation, being helped, living
原	はら, ゲン	meadow, original, primitive, field, plain, prairie, tundra, wilderness
共	とも, とも.に, -ども, キョウ	together, both, neither, all, and, alike, with
得	え.る, う.る, トク	gain, get, find, earn, acquire, can, may, able to, profit, advantage, benefit
解	と.く, と.かす, と.ける, ほど.く, ほど.ける, わか.る, さと.る, カイ, ゲ	unravel, notes, key, explanation, understanding, untie, undo, solve, answer, cancel, absolve, explain, minute
交	まじ.わる, まじ.える, ま.じる, まじ.る, ま.ざる, ま.ぜる, -か.う, か.わす, かわ.す, こもごも, コウ	mingle, mixing, association, coming & going
資	シ	assets, resources, capital, funds, data, be conducive to, contribute to
予	あらかじ.め, ヨ, シャ	beforehand, previous, myself, I
向	む.く, む.い, -む.き, む.ける, -む.け, む.かう, む.かい, む.こう, む.こう-, むこ, むか.い, コウ	yonder, facing, beyond, confront, defy, tend toward, approach
際	きわ, -ぎわ, サイ	occasion, side, edge, verge, dangerous, adventurous, indecent, time, when
査	サ	investigate
勝	か.つ, -が.ち, まさ.る, すぐ.れる, かつ, ショウ	victory, win, prevail, excel
面	おも, おもて, つら, メン, ベン	mask, face, features, surface
委	ゆだ.ねる, イ	committee, entrust to, leave to, devote, discard
告	つ.げる, コク	revelation, tell, inform, announce
軍	いくさ, グン	army, force, troops, war, battle
反	そ.る, そ.らす, かえ.す, かえ.る, -かえ.る, ハン, ホン, タン, ホ	anti-
判	わか.る, ハン, バン	judgement, signature, stamp, seal
認	みと.める, したた.める, ニン	acknowledge, witness, discern, recognize, appreciate, believe
参	まい.る, まい-, まじわる, みつ, サン, シン	nonplussed, three (in documents), going, coming, visiting, visit, be defeated, die, be madly in love, participate, take part in
利	き.く, リ	profit, advantage, benefit
組	く.む, くみ, -ぐみ, ソ	association, braid, plait, construct, assemble, unite, cooperate, grapple
案	つくえ, アン	plan, suggestion, draft, ponder, fear, proposition, idea, expectation, worry, table, bench
信	シン	faith, truth, fidelity, trust
在	あ.る, ザイ	exist, outskirts, suburbs, located in
件	くだん, ケン	affair, case, matter, item
団	かたまり, まる.い, ダン, トン	group, association
側	かわ, がわ, そば, ソク	side, lean, oppose, regret
任	まか.せる, まか.す, ニン	responsibility, duty, term, entrust to, appoint
求	もと.める, キュウ, グ	request, want, wish for, require, demand
次	つ.ぐ, つぎ, ジ, シ	next, order, sequence
昨	サク	yesterday, previous
論	ロン	argument, discourse
官	カン	bureaucrat, the government, organ
増	ま.す, ま.し, ふ.える, ふ.やす, ゾウ	increase, add, augment, gain, promote
係	かか.る, かかり, -がかり, かか.わる, ケイ	person in charge, connection, duty, concern oneself
感	カン	emotion, feeling, sensation
情	なさ.け, ジョウ, セイ	feelings, emotion, passion, sympathy, circumstances, facts
投	な.げる, -な.げ, トウ	throw, discard, abandon, launch into, join, invest in, hurl, give up, sell at a loss
示	しめ.す, ジ, シ	show, indicate, point out, express, display
変	か.わる, か.わり, か.える, ヘン	unusual, change, strange
打	う.つ, う.ち-, ぶ.つ, ダ, ダアス	strike, hit, knock, pound, dozen
基	もと, もとい, キ	fundamentals, radical (chem), counter for machines, foundation
各	おのおの, カク	each, every, either
島	しま, トウ	island
直	ただ.ちに, なお.す, -なお.す, なお.る, なお.き, す.ぐ, チョク, ジキ, ジカ	straightaway, honesty, frankness, fix, repair
両	てる, ふたつ, リョウ	both, old Japanese coin, counter for carriages (e.g., in a train), two
革	かわ, カク	leather, skin, reform, become serious
価	あたい, カ, ケ	value, price
式	シキ	style, ceremony, rite, function, method, system, form, expression
確	たし.か, たし.かめる, カク, コウ	assurance, firm, tight, hard, solid, confirm, clear, evident
果	は.たす, はた.す, -は.たす, は.てる, -は.てる, は.て, カ	fruit, reward, carry out, achieve, complete, end, finish, succeed
勢	いきお.い, はずみ, セイ, ゼイ	forces, energy, military strength
減	へ.る, へ.らす, ゲン	dwindle, decrease, reduce, decline, curtail, get hungry
容	い.れる, ヨウ	contain, form, looks
必	かなら.ず, ヒツ	invariably, certain, inevitable
応	あた.る, まさに, こた.える, オウ, ヨウ, -ノウ	apply, answer, yes, OK, reply, accept
演	エン	performance, act, play, render, stage
歳	とし, とせ, よわい, サイ, セイ	year-end, age, occasion, opportunity
争	あらそ.う, いか.でか, ソウ	contend, dispute, argue
談	ダン	discuss, talk
能	よ.く, ノウ	ability, talent, skill, capacity
無	な.い, ム, ブ	nothingness, none, ain't, nothing, nil, not
再	ふたた.び, サイ, サ	again, twice, second time
位	くらい, ぐらい, イ	rank, grade, throne, crown, about, some
置	お.く, -お.き, チ	placement, put, set, deposit, leave behind, keep, employ, pawn
流	なが.れる, なが.れ, なが.す, -なが.す, リュウ, ル	current, a sink, flow, forfeit
格	カク, コウ, キャク, ゴウ	status, rank, capacity, character, case (law, grammar)
疑	うたが.う, ギ	doubt, distrust, be suspicious, question
過	す.ぎる, -す.ぎる, -す.ぎ, す.ごす, あやま.つ, あやま.ち, よ.ぎる, カ	overdo, exceed, go beyond, error
局	つぼね, キョク	bureau, board, office, affair, conclusion, court lady, lady-in-waiting, her apartment
放	はな.す, -っぱな.し, はな.つ, はな.れる, こ.く, ほう.る, ホウ	set free, release, fire, shoot, emit, banish, liberate
税	ゼイ	tax, duty
検	しら.べる, ケン	examination, investigate
常	つね, とこ-, ジョウ	usual, ordinary, normal, regular
状	ジョウ	status quo, conditions, circumstances, form, appearance
球	たま, キュウ	ball, sphere
営	いとな.む, いとな.み, エイ	occupation, camp, perform, build, conduct (business)
職	ショク, ソク	post, employment, work
与	あた.える, あずか.る, くみ.する, ともに, ヨ	bestow, participate in, give, award, impart, provide, cause, gift, godsend
供	そな.える, とも, -ども, キョウ, ク, クウ, グ	submit, offer, present, serve (meal), accompany
可	-べ.き, -べ.し, カ, コク	can, passable, mustn't, should not, do not
役	ヤク, エキ	duty, war, campaign, drafted labor, office, service, role
構	かま.える, かま.う, コウ	posture, build, pretend
割	わ.る, わり, わ.り, わ.れる, さ.く, カツ	proportion, comparatively, divide, cut, separate, split
身	み, シン	somebody, person, one's station in life
費	つい.やす, つい.える, ヒ	expense, cost, spend, consume, waste
付	つ.ける, -つ.ける, -づ.ける, つ.け, つ.け-, -つ.け, -づ.け, -づけ, つ.く, -づ.く, つ.き, -つ.き, -つき, -づ.き, -づき, フ	adhere, attach, refer to, append
由	よし, よ.る, ユ, ユウ, ユイ	wherefore, a reason
比	くら.べる, ヒ	compare, race, ratio, Philipines
難	かた.い, -がた.い, むずか.しい, むづか.しい, むつか.しい, -にく.い, ナン	difficult, impossible, trouble, accident, defect
防	ふせ.ぐ, ボウ	ward off, defend, protect, resist
補	おぎな.う, ホ	supplement, supply, make good, offset, compensate, assistant, learner
優	やさ.しい, すぐ.れる, まさ.る, ユウ, ウ	tenderness, excel, surpass, actor, superiority, gentleness
夫	おっと, それ, フ, フウ, ブ	husband, man
収	おさ.める, おさ.まる, シュウ	income, obtain, reap, pay, supply, store
断	た.つ, ことわ.る, さだ.める, ダン	severance, decline, refuse, apologize, warn, dismiss, prohibit, decision, judgement, cutting
石	いし, セキ, シャク, コク	stone
違	ちが.う, ちが.い, ちが.える, -ちが.える, たが.う, たが.える, イ	difference, differ
消	き.える, け.す, ショウ	extinguish, blow out, turn off, neutralize, cancel
境	さかい, キョウ, ケイ	boundary, border, region
神	かみ, かん-, こう-, シン, ジン	gods, mind, soul
番	つが.い, バン	turn, number in a series
規	キ	standard, measure
術	すべ, ジュツ	art, technique, skill, means, trick, resources, magic
展	テン	unfold, expand
導	みちび.く, ドウ	guidance, leading, conduct, usher
備	そな.える, そな.わる, つぶさ.に, ビ	equip, provision, preparation
宅	タク	home, house, residence, our house, my husband
害	ガイ	harm, injury
配	くば.る, ハイ	distribute, spouse, exile, rationing
副	フク	vice-, assistant, aide, duplicate, copy
算	そろ, サン	calculate, divining, number, abacus, probability
条	えだ, すじ, ジョウ, チョウ, デキ	article, clause, item, stripe, streak
独	ひと.り, ドク, トク	single, alone, spontaneously, Germany
警	いまし.める, ケイ	admonish, commandment
育	そだ.つ, そだ.ち, そだ.てる, はぐく.む, イク	bring up, grow up, raise, rear
席	むしろ, セキ	seat, mat, occasion, place
輸	ユ, シュ	transport, send, be inferior
訪	おとず.れる, たず.ねる, と.う, ホウ	call on, visit, look up, offer sympathy
述	の.べる, ジュツ	mention, state, speak, relate
残	のこ.る, のこ.す, そこな.う, のこ.り, ザン, サン	remainder, leftover, balance
想	おも.う, ソウ, ソ	concept, think, idea, thought
線	すじ, セン	line, track
率	ひき.いる, ソツ, リツ, シュツ	ratio, rate, proportion, %, coefficient, factor
農	ノウ	agriculture, farmers
州	す, シュウ, ス	state, province
武	たけ.し, ブ, ム	warrior, military, chivalry, arms
念	ネン	wish, sense, idea, thought, feeling, desire, attention
象	かたど.る, ショウ, ゾウ	elephant, pattern after, imitate, image, shape, sign (of the times)
域	イキ	range, region, limits, stage, level
助	たす.ける, たす.かる, す.ける, すけ, ジョ	help, rescue, assist
労	ろう.する, いたわ.る, いた.ずき, ねぎら, つか.れる, ねぎら.う, ロウ	labor, thank for, reward for, toil, trouble
例	たと.える, レイ	example, custom, usage, precedent
然	しか, しか.り, しか.し, さ, ゼン, ネン	sort of thing, so, if so, in that case, well
張	は.る, -は.り, -ば.り, チョウ	lengthen, counter for bows & stringed instruments, stretch, spread, put up (tent)
限	かぎ.る, かぎ.り, -かぎ.り, ゲン	limit, restrict, to best of ability
額	ひたい, ガク	forehead, tablet, plaque, framed picture, sum, amount, volume
環	わ, カン	ring, circle, link, wheel
追	お.う, ツイ	chase, drive away, follow, pursue, meanwhile
商	あきな.う, ショウ	make a deal, selling, dealing in, merchant
葉	は, ヨウ	leaf, plane, lobe, needle, blade, spear, counter for flat things, fragment, piece
伝	つた.わる, つた.える, つた.う, つだ.う, -づた.い, つて, デン, テン	transmit, go along, walk along, follow, report, communicate, legend, tradition
形	かた, -がた, かたち, なり, ケイ, ギョウ	shape, form, style
景	ケイ	scenery, view
落	お.ちる, お.ち, お.とす, ラク	fall, drop, come down, village, hamlet
欧	うた.う, は.く, オウ	Europe
担	かつ.ぐ, にな.う, タン	shouldering, carry, raise, bear
退	しりぞ.く, しりぞ.ける, ひ.く, の.く, の.ける, ど.く, タイ	retreat, withdraw, retire, resign, repel, expel, reject
準	じゅん.じる, じゅん.ずる, なぞら.える, のり, ひと.しい, みずもり, ジュン	semi-, correspond to, proportionate to, conform, imitate
賞	ほ.める, ショウ	prize, reward, praise
辺	あた.り, ほと.り, -べ, ヘン	environs, boundary, border, vicinity
造	つく.る, つく.り, -づく.り, ゾウ	create, make, structure, physique
被	こうむ.る, おお.う, かぶ.る, かぶ.せる, ヒ	incur, cover, veil, brood over, shelter, wear, put on, be exposed (film), receiving
技	わざ, ギ	skill, art, craft, ability, feat, performance, vocation, arts
復	また, フク	restore, return to, revert, resume
負	ま.ける, ま.かす, お.う, フ	defeat, negative, -, minus, bear, owe, assume a responsibility
渡	わた.る, -わた.る, わた.す, ト	transit, ford, ferry, cross, import, deliver, diameter, migrate
失	うしな.う, う.せる, シツ	lose, error, fault, disadvantage, loss
移	うつ.る, うつ.す, イ	shift, move, change, drift, catch (cold, fire), pass into
差	さ.す, さ.し, サ	distinction, difference, variation, discrepancy, margin, balance
個	コ, カ	individual, counter for articles
評	ヒョウ	evaluate, criticism, comment
課	カ	chapter, lesson, section, department, division, counter for chapters (of a book)
末	すえ, マツ, バツ	end, close, tip, powder, posterity
守	まも.る, まも.り, もり, -もり, かみ, シュ, ス	guard, protect, defend, obey
若	わか.い, わか-, も.しくわ, も.し, も.しくは, ごと.し, ジャク, ニャク, ニャ	young, if, perhaps, possibly, low number, immature
脳	のうずる, ノウ, ドウ	brain, memory
極	きわ.める, きわ.まる, きわ.まり, きわ.み, き.める, -ぎ.め, き.まる, キョク, ゴク	poles, settlement, conclusion, end, highest rank, electric poles, very, extremely, most, highly, 10**48
種	たね, -ぐさ, シュ	species, kind, class, variety, seed
美	うつく.しい, ビ, ミ	beauty, beautiful
命	いのち, メイ, ミョウ	fate, command, decree, destiny, life, appoint
含	ふく.む, ふく.める, ガン	contain, include, hold in the mouth, bear in mind, understand, cherish
福	フク	blessing, fortune, luck, wealth
蔵	くら, おさ.める, かく.れる, ゾウ, ソウ	storehouse, hide, own, have, possess
量	はか.る, リョウ	quantity, measure, weight, amount, consider, estimate, surmise
望	のぞ.む, もち, ボウ, モウ	ambition, full moon, hope, desire, aspire to, expect
非	あら.ず, ヒ	un-, mistake, negative, injustice, non-
観	み.る, しめ.す, カン	outlook, look, appearance, condition, view
察	サツ	guess, presume, surmise, judge, understand
整	ととの.える, ととの.う, セイ	organize, arranging, tune, tone, meter, key (music)
段	ダン, タン	grade, steps, stairs
横	よこ, オウ	sideways, side, horizontal, width, woof, unreasonable, perverse
型	かた, -がた, ケイ	mould, type, model
深	ふか.い, -ぶか.い, ふか.まる, ふか.める, み-, シン	deep, heighten, intensify, strengthen
製	セイ	made in..., manufacture
況	まし.て, いわ.んや, おもむき, キョウ	condition, situation
申	もう.す, もう.し-, さる, シン	have the honor to, sign of the monkey, 3-5PM, ninth sign of Chinese zodiac
様	さま, さん, ヨウ, ショウ	Esq., way, manner, situation, polite suffix
財	たから, ザイ, サイ, ゾク	property, money, wealth, assets
港	みなと, コウ	harbor
識	し.る, しる.す, シキ	discriminating, know, write
呼	よ.ぶ, コ	call, call out to, invite
達	-たち, タツ, ダ	accomplished, reach, arrive, attain
良	よ.い, -よ.い, い.い, -い.い, リョウ	good, pleasing, skilled
針	はり, シン	needle, pin, staple, stinger
専	もっぱ.ら, セン	specialty, exclusive, mainly, solely
谷	たに, きわ.まる, コク	valley
候	そうろう, コウ	climate, season, weather, wait for, expect
史	シ	history, chronicle
階	きざはし, カイ	storey, stair, counter for storeys of a building
程	ほど, -ほど, テイ	extent, degree, law, formula, distance, limits, amount
満	み.ちる, み.つ, み.たす, マン, バン	full, fullness, enough, satisfy
敗	やぶ.れる, ハイ	failure, defeat, reversal
管	くだ, カン	pipe, tube, wind instrument, drunken talk, control, jurisdiction
値	ね, あたい, チ	price, cost, value
突	つ.く, トツ, カ	stab, protruding, thrust, pierce, prick, collision, sudden
兵	つわもの, ヘイ, ヒョウ	soldier, private, troops, army, warfare, strategy, tactics
接	つ.ぐ, セツ, ショウ	touch, contact, adjoin, piece together
器	うつわ, キ	utensil, vessel, receptacle, implement, instrument, ability, container, tool, set
路	-じ, みち, ロ, ル	path, route, road, distance
科	カ	department, course, section
授	さず.ける, さず.かる, ジュ	impart, instruct, grant, confer
細	ほそ.い, ほそ.る, こま.か, こま.かい, サイ	dainty, get thin, taper, slender, narrow, detailed, precise
効	き.く, ききめ, なら.う, コウ	merit, efficacy, efficiency, benefit
積	つ.む, -づ.み, つ.もる, つ.もり, セキ	volume, product (x*y), acreage, contents, pile up, stack, load, amass
丸	まる, まる.める, まる.い, ガン	round, full (month), perfection, -ship, pills, make round, roll up, curl up, seduce, explain away
他	ほか, タ	other, another, the others
湾	いりえ, ワン	gulf, bay, inlet
録	しる.す, と.る, ロク	record
処	ところ, -こ, お.る, ショ	dispose, manage, deal with, sentence, condemn, act, behave, place
省	かえり.みる, はぶ.く, セイ, ショウ	focus, government ministry, conserve
旧	ふる.い, もと, キュウ	old times, old things, old friend, former, ex-
橋	はし, キョウ	bridge
岸	きし, ガン	beach
客	キャク, カク	guest, visitor, customer, client
否	いな, いや, ヒ	negate, no, noes, refuse, decline, deny
周	まわ.り, シュウ	circumference, circuit, lap
師	もろもろ, なら.う, シ, ス	expert, teacher, master, model, exemplar, army (incl. counter), war
材	ザイ	lumber, log, timber, wood, materials, ingredients, talent
登	のぼ.る, あ.がる, トウ, ト, ドウ, ショウ, チョウ	ascend, climb up
批	ヒ	criticism, strike
易	やさ.しい, やす.い, エキ, イ	easy, ready to, simple, fortune-telling, divination
健	すこ.やか, ケン	healthy, health, strength, persistence
戸	と, コ	door, counter for houses, door radical (no. 63)
速	はや.い, はや-, はや.める, すみ.やか, ソク	quick, fast
存	ソン, ゾン	exist, suppose, be aware of, believe, feel
飛	と.ぶ, と.ばす, -と.ばす, ヒ	fly, skip (pages), scatter
殺	ころ.す, -ごろ.し, そ.ぐ, サツ, サイ, セツ	kill, murder, butcher, slice off, split, diminish, reduce, spoil
央	オウ	center, middle
券	ケン	ticket
号	さけ.ぶ, よびな, ゴウ	nickname, number, item, title, pseudonym, name, call
単	ひとえ, タン	simple, one, single, merely
座	すわ.る, ザ	squat, seat, cushion, gathering, sit
破	やぶ.る, やぶ.れる, わ.れる, ハ	rend, rip, tear, break, destroy, defeat, frustrate
編	あ.む, -あ.み, ヘン	compilation, knit, plait, braid, twist, editing, completed poem, part of a book
捜	さが.す, ソウ, シュ, シュウ	search, look for, locate
竹	たけ, チク	bamboo
除	のぞ.く, -よ.け, ジョ, ジ	exclude, division (x/3), remove, abolish, cancel, except
完	カン	perfect, completion, end
降	お.りる, お.ろす, ふ.る, ふ.り, くだ.る, くだ.す, コウ, ゴ	descend, precipitate, fall, surrender
超	こ.える, こ.す, チョウ	transcend, super-, ultra-
責	せ.める, セキ	blame, condemn, censure
並	な.み, なみ, なら.べる, なら.ぶ, なら.びに, ヘイ, ホウ	row, and, besides, as well as, line up, rank with, rival, equal
療	リョウ	heal, cure
修	おさ.める, おさ.まる, シュウ, シュ	discipline, conduct oneself well, study, master
捕	と.らえる, と.らわれる, と.る, とら.える, とら.われる, つか.まえる, つか.まる, ホ	catch, capture
危	あぶ.ない, あや.うい, あや.ぶむ, キ	dangerous, fear, uneasy
採	と.る, サイ	pick, take, fetch, take up
競	きそ.う, せ.る, くら.べる, キョウ, ケイ	emulate, compete with, bid, sell at auction, bout, contest, race
拡	ひろ.がる, ひろ.げる, ひろ.める, カク, コウ	broaden, extend, expand, enlarge
故	ゆえ, ふる.い, もと, コ	happenstance, especially, intentionally, reason, cause, circumstances, the late, therefore, consequently
給	たま.う, たも.う, -たま.え, キュウ	salary, wage, gift, allow, grant, bestow on
介	カイ	jammed in, shellfish, mediate, concern oneself with
根	ね, -ね, コン	root, radical, head (pimple)
苦	くる.しい, -ぐる.しい, くる.しむ, くる.しめる, にが.い, にが.る, ク	suffering, trial, worry, hardship, feel bitter, scowl
迎	むか.える, ゲイ	welcome, meet, greet
販	ハン	marketing, sell, trade
園	その, エン	park, garden, yard, farm
具	そな.える, つぶさ.に, グ	tool, utensil, means, possess, ingredients, counter for armor, suits, sets of furniture
異	こと, こと.なる, け, イ	uncommon, different, queerness, strangeness, wonderful, curious, unusual
歴	レキ, レッキ	curriculum, continuation, passage of time
辞	や.める, いな.む, ジ	resign, word, term, expression
将	まさ.に, はた, まさ, ひきい.る, もって, ショウ, ソウ	leader, commander, general, admiral, or, and again, soon, from now on, just about
因	よ.る, ちな.む, イン	cause, factor, be associated with, depend on, be limited to
馬	うま, うま-, ま, バ	horse
愛	いと.しい, かな.しい, め.でる, お.しむ, まな, アイ	love, affection, favourite
幅	はば, フク	hanging scroll, width
富	と.む, とみ, フ, フウ	wealth, enrich, abundant
彼	かれ, かの, か.の, ヒ	he, that, the
般	ハン	carrier, carry, all, general, sort, kind
未	いま.だ, ま.だ, ひつじ, ミ, ビ	un-, not yet, hitherto, still, even now, sign of the ram, 1-3PM, eighth sign of Chinese zodiac
貿	ボウ	trade, exchange
講	コウ	lecture, club, association
舞	ま.う, -ま.う, まい, ブ	dance, flit, circle, wheel
装	よそお.う, よそお.い, ソウ, ショウ	attire, dress, pretend, disguise, profess
諸	もろ, ショ	various, many, several, together
亡	な.い, な.き-, ほろ.びる, ほろ.ぶ, ほろ.ぼす, ボウ, モウ	deceased, the late, dying, perish
劇	ゲキ	drama, play
河	かわ, カ	river
航	コウ	navigate, sail, cruise, fly
冷	つめ.たい, ひ.える, ひ.や, ひ.ややか, ひ.やす, ひ.やかす, さ.める, さ.ます, レイ	cool, cold (beer, person), chill
適	かな.う, テキ	suitable, occasional, rare, qualified, capable
婦	よめ, フ	lady, woman, wife, bride
鉄	くろがね, テツ	iron
寄	よ.る, -よ.り, よ.せる, キ	draw near, stop in, bring near, gather, collect, send, forward
込	-こ.む, こ.む, こ.み, -こ.み, こ.める	crowded, mixture, in bulk, included, (kokuji)
類	たぐ.い, ルイ	sort, kind, variety, class, genus
児	こ, -こ, -っこ, ジ, ニ, ゲイ	newborn babe, child, young of animals
余	あま.る, あま.り, あま.す, あんま.り, ヨ	too much, myself, surplus, other, remainder
禁	キン	prohibition, ban, forbid
印	しるし, -じるし, しる.す, イン	stamp, seal, mark, imprint, symbol, emblem, trademark, evidence, souvenir, India
逆	さか, さか.さ, さか.らう, ギャク, ゲキ	inverted, reverse, opposite, wicked
王	オウ, -ノウ	king, rule, magnate
返	かえ.す, -かえ.す, かえ.る, -かえ.る, ヘン	return, answer, fade, repay
標	しるべ, しるし, ヒョウ	signpost, seal, mark, stamp, imprint, symbol, emblem, trademark, evidence, souvenir, target
換	か.える, -か.える, か.わる, カン	interchange, period, change, convert, replace, renew
久	ひさ.しい, キュウ, ク	long time, old story
油	あぶら, ユ, ユウ	oil, fat
妻	つま, サイ	wife, spouse
暴	あば.く, あば.れる, ボウ, バク	outburst, rave, fret, force, violence, cruelty, outrage
輪	わ, リン	wheel, ring, circle, link, loop, counter for wheels and flowers
占	し.める, うらな.う, セン	fortune-telling, divining, forecasting, occupy, hold, have, get, take
背	せ, せい, そむ.く, そむ.ける, ハイ	stature, height, back, behind, disobey, defy, go back on, rebel
植	う.える, う.わる, ショク	plant
熱	あつ.い, ネツ	heat, temperature, fever, mania, passion
宿	やど, やど.る, やど.す, シュク	inn, lodging, relay station, dwell, lodge, be pregnant, home, dwelling
清	きよ.い, きよ.まる, きよ.める, セイ, ショウ, シン	pure, purify, cleanse, exorcise, Manchu dynasty
険	けわ.しい, ケン	precipitous, inaccessible place, impregnable position, steep place, sharp eyes
頼	たの.む, たの.もしい, たよ.る, ライ	trust, request
覚	おぼ.える, さ.ます, さ.める, さと.る, カク	memorize, learn, remember, awake, sober up
船	ふね, ふな-, セン	ship, boat
倍	バイ	double, twice, times, fold
均	なら.す, キン	level, average
億	オク	hundred million, 10**8
途	みち, ト	route, way, road
圧	お.す, へ.す, おさ.える, お.さえる, アツ, エン, オウ	pressure, push, overwhelm, oppress, dominate
芸	う.える, のり, わざ, ゲイ, ウン	technique, art, craft, performance, acting, trick, stunt
許	ゆる.す, もと, キョ	permit, approve
署	ショ	signature, govt office, police station
抜	ぬ.く, -ぬ.く, ぬ.き, ぬ.ける, ぬ.かす, ぬ.かる, バツ, ハツ, ハイ	slip out, extract, pull out, pilfer, quote, remove, omit
伸	の.びる, の.ばす, の.べる, の.す, シン	expand, stretch, extend, lengthen, increase
留	と.める, と.まる, とど.める, とど.まる, るうぶる, リュウ, ル	detain, fasten, halt, stop
罪	つみ, ザイ	guilt, sin, crime, fault, blame, offense
停	と.める, と.まる, テイ	halt, stopping
爆	は.ぜる, バク	bomb, burst open, pop, split
陸	おか, リク, ロク	land, six
玉	たま, たま-, -だま, ギョク	jewel, ball
波	なみ, ハ	waves, billows, Poland
帯	お.びる, おび, タイ	sash, belt, obi, zone, region
延	の.びる, の.べる, の.べ, の.ばす, エン	prolong, stretching
羽	は, わ, はね, ウ	feathers, counter for birds, rabbits
努	つと.める, ド	toil, diligent, as much as possible
固	かた.める, かた.まる, かた.まり, かた.い, コ	harden, set, clot, curdle
精	セイ, ショウ, シヤウ	refined, ghost, fairy, energy, vitality, semen, excellence, purity, skill
則	のっと.る, ソク	rule, follow, based on, model after
乱	みだ.れる, みだ.る, みだ.す, みだ, おさ.める, わた.る, ラン, ロン	riot, war, disorder, disturb
普	あまね.く, あまねし, フ	universal, wide(ly), generally, Prussia
散	ち.る, ち.らす, -ち.らす, ち.らかす, ち.らかる, ち.らばる, ばら, ばら.ける, サン	scatter, disperse, spend, squander
司	つかさど.る, シ	director, official, govt office, rule, administer
康	コウ	ease, peace
測	はか.る, ソク	fathom, plan, scheme, measure
豊	ゆた.か, とよ, ホウ, ブ	bountiful, excellent, rich
静	しず-, しず.か, しず.まる, しず.める, セイ, ジョウ	quiet
善	よ.い, い.い, よ.く, よし.とする, ゼン	virtuous, good, goodness
婚	コン	marriage
厚	あつ.い, あか, コウ	thick, heavy, rich, kind, cordial, brazen, shameless
喜	よろこ.ぶ, よろこ.ばす, キ	rejoice, take pleasure in
齢	よわい, とし, レイ	age
囲	かこ.む, かこ.う, かこ.い, イ	surround, besiege, store, paling, enclosure, encircle, preserve, keep
卒	そっ.する, お.える, お.わる, ついに, にわか, ソツ, シュツ	graduate, soldier, private, die
略	ほぼ, おか.す, おさ.める, はかりごと, はか.る, はぶ.く, りゃく.す, りゃく.する, リャク	abbreviation, omission, outline, shorten, capture, plunder
承	うけたまわ.る, う.ける, ささ.げる, とど.める, たす.ける, こ.らす, つい.で, すく.う, ショウ, ジョウ	acquiesce, hear, listen to, be informed, receive
浮	う.く, う.かれる, う.かぶ, む, う.かべる, フ	floating, float, rise to surface
順	ジュン	obey, order, turn, right, docility, occasion
絶	た.える, た.やす, た.つ, ゼツ	discontinue, beyond, sever, cut off, abstain, interrupt, suppress
級	キュウ	class, rank, grade
幸	さいわ.い, さち, しあわ.せ, コウ	happiness, blessing, fortune
岩	いわ, ガン	boulder, rock, cliff
練	ね.る, ね.り, レン	practice, gloss, train, drill, polish, refine
押	お.す, お.し-, お.っ-, お.さえる, おさ.える, オウ	push, stop, check, subdue, attach, seize, weight, shove, press, seal, do in spite of
倒	たお.れる, -だお.れ, たお.す, さかさま, さかさ, さかしま, トウ	overthrow, fall, collapse, drop, break down
了	リョウ	complete, finish
庁	やくしょ, チョウ, テイ	government office
城	しろ, ジョウ	castle
等	ひと.しい, など, -ら, トウ	etc., and so forth, class (first), quality, equal, similar
救	すく.う, キュウ	salvation, save, help, rescue, reclaim
層	ソウ	stratum, social class, layer, story, floor
版	ハン	printing block, printing plate, edition, impression, label
老	お.いる, ふ.ける, ロウ	old man, old age, grow old
令	レイ	orders, ancient laws, command, decree
角	かど, つの, カク	angle, corner, square, horn, antlers
絡	から.む, から.まる, ラク	entwine, coil around, get caught in
損	そこ.なう, そこな.う, -そこ.なう, そこ.ねる, -そこ.ねる, ソン	damage, loss, disadvantage, hurt, injure
募	つの.る, ボ	recruit, campaign, gather (contributions), enlist, grow violent
曲	ま.がる, ま.げる, くま, キョク	bend, music, melody, composition, pleasure, injustice, fault, curve, crooked, perverse, lean
裏	うら, リ	back, amidst, in, reverse, inside, palm, sole, rear, lining, wrong side
払	はら.う, -はら.い, -ばら.い, フツ, ヒツ, ホツ	pay, clear out, prune, banish, dispose of
庭	にわ, テイ	courtyard, garden, yard
徒	いたずら, あだ, ト	on foot, junior, emptiness, vanity, futility, uselessness, ephemeral thing, gang, set, party, people
仏	ほとけ, ブツ, フツ	Buddha, the dead, France
績	セキ	exploits, achievements, unreeling cocoons
築	きず.く, チク	fabricate, build, construct
貨	たから, カ	freight, goods, property
志	シリング, こころざ.す, こころざし, シ	intention, plan, resolve, aspire, motive, hopes, shilling
混	ま.じる, -ま.じり, ま.ざる, ま.ぜる, こ.む, コン	mix, blend, confuse
昇	のぼ.る, ショウ	rise up
勤	つと.める, -づと.め, つと.まる, いそ.しむ, キン, ゴン	diligence, become employed, serve
血	ち, ケツ	blood
遅	おく.れる, おく.らす, おそ.い, チ	slow, late, back, later
居	い.る, -い, お.る, キョ, コ	reside, to be, exist, live with
温	あたた.か, あたた.かい, あたた.まる, あたた.める, ぬく, オン	warm
雑	まじ.える, まじ.る, ザツ, ゾウ	miscellaneous
招	まね.く, ショウ	beckon, invite, summon, engage
季	キ	seasons
困	こま.る, コン	quandary, become distressed, annoyed
星	ほし, -ぼし, セイ, ショウ	star, spot, dot, mark
永	なが.い, エイ	eternity, long, lengthy
著	あらわ.す, いちじる.しい, チョ, チャク	renowned, publish, write, remarkable, phenomenal, put on, don, wear, arrival, finish (race), counter for suits of clothing, literary work
誌	シ	document, records
庫	くら, コ, ク	warehouse, storehouse
刊	カン	publish, carve, engrave
像	ゾウ	statue, picture, image, figure, portrait
香	か, かお.り, かお.る, コウ, キョウ	incense, smell, perfume
欠	か.ける, か.く, ケツ, ケン	lack, gap, fail, yawning radical (no. 76)
更	さら, さら.に, ふ.ける, ふ.かす, コウ	grow late, night watch, sit up late, of course, renew, renovate, again, more and more, further
坂	さか, ハン	slope, incline, hill
刻	きざ.む, きざ.み, コク	engrave, cut fine, chop, hash, mince, time, carving
底	そこ, テイ	bottom, sole, depth, bottom price, base, kind, sort
賛	たす.ける, たた.える, サン	approve, praise, title or inscription on picture, assist, agree with
抱	だ.く, いだ.く, かか.える, ホウ	embrace, hug, hold in arms
犯	おか.す, ハン, ボン	crime, sin, offense
布	ぬの, フ	linen, cloth, spread, distribute
恐	おそ.れる, おそ.る, おそ.ろしい, こわ.い, こわ.がる, キョウ	fear, dread, awe
寺	てら, ジ	Buddhist temple
息	いき, ソク	breath, respiration, son, interest (on money)
宇	ウ	eaves, roof, house, heaven
戻	もど.す, もど.る, レイ	re-, return, revert, resume, restore, go backwards
巨	キョ	gigantic, big, large, great
震	ふる.う, ふる.える, シン	quake, shake, tremble, quiver, shiver
願	ねが.う, -ねがい, ガン	petition, request, vow, wish, hope
絵	カイ, エ	picture, drawing, painting, sketch
希	まれ, キ, ケ	hope, beg, request, pray, beseech, Greece, dilute (acid), rare, few, phenomenal
越	こ.す, -こ.す, -ご.し, こ.える, -ご.え, エツ, オツ	surpass, cross over, move to, exceed, Vietnam
欲	ほっ.する, ほ.しい, ヨク	longing, covetousness, greed, passion, desire, craving
痛	いた.い, いた.む, いた.ましい, いた.める, ツウ	pain, hurt, damage, bruise
触	ふ.れる, さわ.る, さわ, ショク	contact, touch, feel, hit, proclaim, announce, conflict
依	よ.る, イ, エ	reliant, depend on, consequently, therefore, due to
汚	けが.す, けが.れる, けが.らわしい, よご.す, よご.れる, きたな.い, オ	dirty, pollute, disgrace, rape, defile
枚	マイ, バイ	sheet of..., counter for flat thin objects or sheets
笑	わら.う, え.む, ショウ	laugh
互	たが.い, かたみ.に, ゴ	mutually, reciprocally, together
複	フク	duplicate, double, compound, multiple
郵	ユウ	mail, stagecoach stop
束	たば, たば.ねる, つか, つか.ねる, ソク	bundle, sheaf, ream, tie in bundles, govern, manage, control
仲	なか, チュウ	go-between, relationship
栄	さか.える, は.え, -ば.え, は.える, え, エイ, ヨウ	flourish, prosperity, honor, glory, splendor
札	ふだ, サツ	tag, paper money, counter for bonds, placard, bid
似	に.る, ひ.る, ジ	becoming, resemble, counterfeit, imitate, suitable
恵	めぐ.む, めぐ.み, ケイ, エ	favor, blessing, grace, kindness
板	いた, ハン, バン	plank, board, plate, stage
列	レツ, レ	file, row, rank, tier, column
探	さぐ.る, さが.す, タン	grope, search, look for
逃	に.げる, に.がす, のが.す, のが.れる, トウ	escape, flee, shirk, evade, set free
節	ふし, -ぶし, のっと, セツ, セチ	node, season, period, occasion, verse, clause, stanza, honor, joint, knuckle, knob, knot, tune, melody
骨	ほね, コツ	skeleton, bone, remains, frame
傾	かたむ.く, かたむ.ける, かたぶ.く, かた.げる, かし.げる, ケイ	lean, incline, tilt, trend, wane, sink, ruin, bias
届	とど.ける, -とど.け, とど.く, カイ	deliver, reach, arrive, report, notify, forward
遊	あそ.ぶ, あそ.ばす, ユウ, ユ	play
迷	まよ.う, メイ	astray, be perplexed, in doubt, lost, err, illusion
夢	ゆめ, ゆめ.みる, くら.い, ム, ボウ	dream, vision, illusion
巻	ま.く, まき, ま.き, カン, ケン	scroll, volume, book, part, roll up, wind up, tie, coil, counter for texts (or book scrolls)
君	きみ, -ぎみ, クン	mister, you, ruler, male name suffix
燃	も.える, も.やす, も.す, ネン	burn, blaze, glow
閉	と.じる, と.ざす, し.める, し.まる, た.てる, ヘイ	closed, shut
緒	お, いとぐち, ショ, チョ	thong, beginning, inception, end, cord, strap, mental or emotional state
包	つつ.む, くる.む, ホウ	wrap, pack up, cover, conceal
駐	チュウ	stop-over, reside in, resident
賃	チン	fare, fee, hire, rent, wages, charge
折	お.る, おり, お.り, -お.り, お.れる, セツ	fold, break, fracture, bend, yield, submit
紹	ショウ	introduce, inherit, help
草	くさ, くさ-, -ぐさ, ソウ	grass, weeds, herbs, pasture, write, draft
雇	やと.う, コ	employ, hire
暮	く.れる, く.らす, ボ	evening, twilight, season's end, livelihood, make a living, spend time
替	か.える, か.え-, か.わる, タイ	exchange, spare, substitute, per-
預	あず.ける, あず.かる, ヨ	deposit, custody, leave with, entrust to
焼	や.く, や.き, や.き-, -や.き, や.ける, ショウ	bake, burning
簡	えら.ぶ, ふだ, カン, ケン	simplicity, brevity
章	ショウ	badge, chapter, composition, poem, design
臓	はらわた, ゾウ	entrails, viscera, bowels
律	リツ, リチ, レツ	rhythm, law, regulation, gauge, control
贈	おく.る, ゾウ, ソウ	presents, send, give to, award to, confer on, presenting something
照	て.る, て.らす, て.れる, ショウ	illuminate, shine, compare, bashful
宙	チュウ	mid-air, air, space, sky, memorization, interval of time
酒	さけ, さか-, シュ	sake, alcohol
薄	うす.い, うす-, -うす, うす.める, うす.まる, うす.らぐ, うす.ら-, うす.れる, すすき, ハク	dilute, thin, weak (tea), pampas grass
群	む.れる, む.れ, むら, むら.がる, グン	flock, group, crowd, herd, swarm, cluster
悲	かな.しい, かな.しむ, ヒ	grieve, sad, deplore, regret
秒	ビョウ	second (1/60 minute)
操	みさお, あやつ.る, ソウ, サン	maneuver, manipulate, operate, steer, chastity, virginity, fidelity
奥	おく, おく.まる, くま, オウ	heart, interior
詰	つ.める, つ.め, -づ.め, つ.まる, つ.む, キツ, キチ	packed, close, pressed, reprove, rebuke, blame
晴	は.れる, は.れ, は.れ-, -ば.れ, は.らす, セイ	clear up
双	ふた, たぐい, ならぶ, ふたつ, ソウ	pair, set, comparison, counter for pairs
刺	さ.す, さ.さる, さ.し, さし, とげ, シ	thorn, pierce, stab, prick, sting, calling card
到	いた.る, トウ	arrival, proceed, reach, attain, result in
寝	ね.る, ね.かす, い.ぬ, みたまや, や.める, シン	lie down, sleep, rest, bed, remain unsold
壁	かべ, ヘキ	wall, lining (stomach), fence
仮	かり, かり-, カ, ケ	sham, temporary, interim, assumed (name), informal
純	ジュン	genuine, purity, innocence, net (profit)
盗	ぬす.む, ぬす.み, トウ	steal, rob, pilfer
吸	す.う, キュウ	suck, imbibe, inhale, sip
看	み.る, カン	watch over, see
翌	ヨク	the following, next
陽	ひ, ヨウ	sunshine, yang principle, positive, male, heaven, daytime
快	こころよ.い, カイ	cheerful, pleasant, agreeable, comfortable
片	かた-, かた, ヘン	one-sided, leaf, sheet, right-side kata radical (no. 91)
敬	うやま.う, ケイ, キョウ	awe, respect, honor, revere
悩	なや.む, なや.ます, なや.ましい, なやみ, ノウ	trouble, worry, in pain, distress, illness
泉	いずみ, セン	spring, fountain
御	おん-, お-, み-, ギョ, ゴ	honorable, manipulate, govern
皮	かわ, ヒ	pelt, skin, hide, leather, skin radical (no. 107)
漁	あさ.る, ギョ, リョウ	fishing, fishery
荒	あら.い, あら-, あ.れる, あ.らす, -あ.らし, すさ.む, コウ	laid waste, rough, rude, wild
貯	た.める, たくわ.える, チョ	savings, store, lay in, keep, wear mustache
硬	かた.い, コウ	stiff, hard
歯	よわい, は, よわ.い, よわい.する, シ	tooth, cog
埋	う.める, う.まる, う.もれる, うず.める, うず.まる, い.ける, マイ	bury, be filled up, embedded
柱	はしら, チュウ	pillar, post, cylinder, support
祭	まつ.る, まつ.り, まつり, サイ	ritual, offer prayers, celebrate, deify, enshrine, worship
袋	ふくろ, タイ, ダイ	sack, bag, pouch
忘	わす.れる, ボウ	forget
雪	ゆき, セツ	snow
筆	ふで, ヒツ	writing brush, writing, painting brush, handwriting
吹	ふ.く, スイ	blow, breathe, puff, emit, smoke
訓	おし.える, よ.む, くん.ずる, クン, キン	instruction, Japanese character reading, explanation, read
浴	あ.びる, あ.びせる, ヨク	bathe, be favored with, bask in
童	わらべ, ドウ	juvenile, child
宝	たから, ホウ	treasure, wealth, valuables
封	フウ, ホウ	seal, closing
胸	むね, むな-, キョウ	bosom, breast, chest, heart, feelings
娘	むすめ, こ, ジョウ	daughter, girl
砂	すな, サ, シャ	sand
塩	しお, エン	salt
誤	あやま.る, -あやま.る, ゴ	mistake, err, do wrong, mislead
賢	かしこ.い, ケン	intelligent, wise, wisdom, cleverness
腕	うで, ワン	arm, ability, talent
較	くら.べる, カク, コウ	contrast, compare
兆	きざ.す, きざ.し, チョウ	portent, 10**12, trillion, sign, omen, symptoms
床	とこ, ゆか, ショウ	bed, counter for beds, floor, padding, tatami
畑	はた, はたけ, -ばたけ	farm, field, garden, one's specialty, (kokuji)
慣	な.れる, な.らす, カン	accustomed, get used to, become experienced
毛	け, モウ	fur, hair, feather, down
緑	みどり, リョク, ロク	green
尊	たっと.い, とうと.い, たっと.ぶ, とうと.ぶ, ソン	revered, valuable, precious, noble, exalted
祝	いわ.う, シュク, シュウ	celebrate, congratulate
礼	レイ, ライ	salute, bow, ceremony, thanks, remuneration
窓	まど, てんまど, けむだし, ソウ, ス	window, pane
柔	やわ.らか, やわ.らかい, やわ, やわ.ら, ジュウ, ニュウ	tender, weakness, gentleness, softness
昔	むかし, セキ, シャク	once upon a time, antiquity, old times
殿	との, -どの, デン, テン	Mr., hall, mansion, palace, temple, lord
濃	こ.い, ノウ	concentrated, thick, dark, undiluted
液	エキ	fluid, liquid, juice, sap, secretion
貧	まず.しい, ヒン, ビン	poverty, poor
衣	ころも, きぬ, -ぎ, イ, エ	garment, clothes, dressing
肩	かた, ケン	shoulder
零	ぜろ, こぼ.す, こぼ.れる, レイ	zero, spill, overflow, nothing, cipher
怒	いか.る, おこ.る, ド, ヌ	angry, be offended
泳	およ.ぐ, エイ	swim
祖	ソ	ancestor, pioneer, founder
幼	おさな.い, ヨウ	infancy, childhood
荷	に, カ	baggage, shoulder-pole load, bear (a burden), shoulder (a gun), load, cargo, freight
泊	と.まる, と.める, ハク	overnight, put up at, ride at anchor, 3-day stay
杯	さかずき, ハイ	counter for cupfuls, wine glass, glass, toast
黄	き, こ-, コウ, オウ	yellow
甘	あま.い, あま.える, あま.やかす, うま.い, カン	sweet, coax, pamper, be content, sugary
臣	シン, ジン	retainer, subject
浅	あさ.い, セン	shallow, superficial, frivolous, wretched, shameful
掃	は.く, ソウ, シュ	sweep, brush
雲	くも, -ぐも, ウン	cloud
掘	ほ.る, クツ	dig, delve, excavate
疲	つか.れる, -づか.れ, つか.らす, ヒ	exhausted, tire, weary
捨	す.てる, シャ	discard, throw away, abandon, resign, reject, sacrifice
皆	みな, みんな, カイ	all, everything
軟	やわ.らか, やわ.らかい, ナン	soft
沈	しず.む, しず.める, チン, ジン	sink, be submerged, subside, be depressed, aloes
鳴	な.く, な.る, な.らす, メイ	chirp, cry, bark, sound, ring, echo, honk
凍	こお.る, こご.える, こご.る, い.てる, し.みる, トウ	frozen, congeal, refrigerate
腹	はら, フク	abdomen, belly, stomach
乳	ちち, ち, ニュウ	milk, breasts
煙	けむ.る, けむり, けむ.い, エン	smoke
恋	こ.う, こい, こい.しい, レン	romance, in love, yearn for, miss, darling
紅	べに, くれない, あか.い, コウ, ク	crimson, deep red
郊	コウ	outskirts, suburbs, rural area
腰	こし, ヨウ	loins, hips, waist, low wainscoting
炭	すみ, タン	charcoal, coal
踊	おど.る, ヨウ	jump, dance, leap, skip
冊	ふみ, サツ, サク	tome, counter for books, volume
眠	ねむ.る, ねむ.い, ミン	sleep, die, sleepy
勇	いさ.む, ユウ	courage, cheer up, be in high spirits, bravery, heroism
械	かせ, カイ	contraption, fetter, machine, instrument
怖	こわ.い, こわ.がる, お.じる, おそ.れる, フ, ホ	dreadful, be frightened, fearful
珍	めずら.しい, たから, チン	rare, curious, strange
卵	たまご, ラン	egg, ovum, spawn, roe
湖	みずうみ, コ	lake
狭	せま.い, せば.める, せば.まる, さ, キョウ, コウ	cramped, narrow, contract, tight
喫	の.む, キツ	consume, eat, drink, smoke, receive (a blow)
干	ほ.す, ほ.し-, -ぼ.し, ひ.る, カン	dry, parch, ebb, recede, interfere, intercede
頂	いただ.く, いただき, チョウ	place on the head, receive, top of head, top, summit, peak
虫	むし, チュウ, キ	insect, bug, temper
刷	す.る, -ず.り, -ずり, は.く, サツ	printing, print, brush
湯	ゆ, トウ	hot water, bath, hot spring
箱	はこ, ソウ	box, chest, case, bin, railway car
溶	と.ける, と.かす, と.く, ヨウ	melt, dissolve, thaw
暖	あたた.か, あたた.かい, あたた.まる, あたた.める, ダン, ノン	warmth
鉱	あらがね, コウ	mineral, ore
泣	な.く, キュウ	cry, weep, moan
涙	なみだ, ルイ, レイ	tears, sympathy
匹	ひき, ヒツ	equal, head, counter for small animals, roll of cloth
孫	まご, ソン	grandchild, descendants
鋭	するど.い, エイ	pointed, sharpness, edge, weapon, sharp, violent
枝	えだ, シ	bough, branch, twig, limb, counter for branches
塗	ぬ.る, ぬ.り, まみ.れる, ト	paint, plaster, daub, smear, coating
軒	のき, ケン	flats, counter for houses, eaves
毒	ドク	poison, virus, venom, germ, harm, injury, spite
晩	バン	nightfall, night
叫	さけ.ぶ, キョウ	shout, exclaim, yell
拝	おが.む, おろが.む, ハイ	worship, adore, pray to
氷	こおり, ひ, こお.る, ヒョウ	icicle, ice, hail, freeze, congeal
乾	かわ.く, かわ.かす, ほ.す, ひ.る, いぬい, カン, ケン	drought, dry, dessicate, drink up, heaven, emperor
棒	ボウ	rod, stick, cane, pole, club, line
祈	いの.る, キ	pray, wish
髪	かみ, ハツ	hair of the head
忙	いそが.しい, せわ.しい, おそ.れる, うれえるさま, ボウ, モウ	busy, occupied, restless
拾	ひろ.う, シュウ, ジュウ	pick up, gather, find, go on foot, ten
粉	デシメートル, こ, こな, フン	flour, powder, dust
糸	いと, シ	thread
綿	わた, メン	cotton
才	サイ	genius, years old, cubic shaku
汗	あせ, カン	sweat, perspire
銅	あかがね, ドウ	copper
湿	しめ.る, しめ.す, うるお.う, うるお.す, シツ, シュウ	damp, wet, moist
咲	さ.く, -ざき, ショウ	blossom, bloom
召	め.す, ショウ	seduce, call, send for, wear, put on, ride in, buy, eat, drink, catch (cold)
脂	あぶら, シ	fat, grease, tallow, lard, rosin, gum, tar
蒸	む.す, む.れる, む.らす, ジョウ, セイ	steam, heat, sultry, foment, get musty
肌	はだ, キ	texture, skin, body, grain
靴	くつ, カ	shoes
耕	たがや.す, コウ	till, plow, cultivate
鈍	にぶ.い, にぶ.る, にぶ-, なま.る, なまく.ら, ドン	dull, slow, foolish, blunt
恥	は.じる, はじ, は.じらう, は.ずかしい, チ	shame, dishonor
泥	どろ, デイ, ナイ, デ, ニ	mud, mire, adhere to, be attached to
隅	すみ, グウ	corner, nook
偶	たま, グウ	accidentally, even number, couple, man & wife, same kind
灯	ひ, ほ-, ともしび, とも.す, あかり, トウ	lamp, a light, light, counter for lights
辛	から.い, つら.い, -づら.い, かのと, シン	spicy, bitter, hot, acrid
磨	みが.く, す.る, マ	grind, polish, scour, improve, brush (teeth)
麦	むぎ, バク	barley, wheat
姓	セイ, ショウ	surname
筒	つつ, トウ	cylinder, pipe, tube, gun barrel, sleeve
鼻	はな, ビ	nose, snout
粒	つぶ, リュウ	grains, drop, counter for tiny particles
詞	シ	part of speech, words, poetry
偉	えら.い, イ	admirable, greatness, remarkable, conceited, famous, excellent
胃	イ	stomach, paunch, crop, craw
畳	たた.む, たたみ, かさ.なる, ジョウ, チョウ	tatami mat, counter for tatami mats, fold, shut up, do away with
机	つくえ, キ	desk, table
膚	はだ, フ	skin, body, grain, texture, disposition
濯	すす.ぐ, ゆす.ぐ, タク	laundry, wash, pour on, rinse
猫	ねこ, ビョウ	cat
塔	トウ	pagoda, tower, steeple
沸	わ.く, わ.かす, フツ	seethe, boil, ferment, uproar, breed
灰	はい, カイ	ashes, puckery juice, cremate
菓	カ	candy, cakes, fruit
帽	ずきん, おお.う, ボウ, モウ	cap, headgear
枯	か.れる, か.らす, コ	wither, die, dry up, be seasoned
涼	すず.しい, すず.む, すず.やか, うす.い, ひや.す, まことに, リョウ	refreshing, nice and cool
舟	ふね, ふな-, -ぶね, シュウ	boat, ship
貝	かい, バイ	shellfish
符	フ	token, sign, mark, tally, charm
憎	にく.む, にく.い, にく.らしい, にく.しみ, ゾウ	hate, detest
皿	さら, ベイ	dish, a helping, plate
肯	がえんじ.る, コウ	agreement, consent, comply with
燥	はしゃ.ぐ, ソウ	parch, dry up
畜	チク	livestock, domestic fowl and animals
坊	ボウ, ボッ	boy, priest's residence, priest
挟	はさ.む, はさ.まる, わきばさ.む, さしはさ.む, キョウ, ショウ	pinch, between
曇	くも.る, ドン	cloudy weather, cloud up
滴	しずく, したた.る, テキ	drip, drop
伺	うかが.う, シ	pay respects, visit, ask, inquire, question, implore
