押さえる	おさえる	to pin something down, to hold something down, to hold something back, to stop, to restrain, to curb., to seize, to grasp, to arrest., to gain control of something, to govern, to keep down (e.g. information), to suppress., to catch happening, to determine (important points), to find (proof), to understand.
割引	わりびき	discount, reduction, rebate, (after a number) tenths discounted, tenths reduced.
耐える	たえる, こらえる, こたえる	to bear, to stand, to endure, to put up with., to support, to withstand, to resist, to brave., to be fit for, to be equal to.
伯父	おじ, はくふ, しゅくふ	uncle.
受取り	うけとり	receipt.
物指	ものさし	ruler, measure.
乗り換え	のりかえ	transfer (trains, buses, etc.), connection, connexion., switching (stock)., chromosomal crossover, crossing over.
売り上げ	うりあげ	amount sold, sales, proceeds, takings, turnover.
締め切り	しめきり	deadline, closing, cut-off, end., cofferdam., closed (door, window, etc.).
住まい	すまい, じゅうきょ	dwelling, house, residence, address.
的確	てきかく, てっかく	precise, accurate.
足跡	あしあと, そくせき	footprints., record of page visitors (e.g. in social networking sites).
伯母	おば, はくぼ, しゅくぼ	aunt.
呼びかける	よびかける	to call out to, to accost, to address (crowd), to appeal.
思い切り	おもいきり, おもいっきり	with all one's strength, with all one's heart, resignation, resolution.
灯	ひ, とうか, ともしび	light, lamp, torch.
基準	きじゅん	standard, basis, criterion, norm, reference, datum.
塊	かたまり	lump, mass, bundle, clump, clod, cluster.
手続	てつづき	procedure, (legal) process, formalities.
交代	こうたい	alternation, change, relief, relay, shift, substitution (sports, etc.).
話し合い	はなしあい	discussion, conference.
主人	しゅじん	head (of a household), proprietor (of a store), proprietress, landlord, landlady., one's husband., (one's) employer, (one's) master., host, hostess.
付属	ふぞく	attached, belonging (to), included, enclosed, affiliated, annexed, associated, subordinate, incidental, dependent, auxiliary.
割	わり	rate, ratio, proportion, percentage., profit., assignment., 10%, unit of ten percent., match, schedule of matches., diluted with (of drinks), mixed with.
当たり前	あたりまえ	natural, reasonable, obvious., usual, common, ordinary, commonplace, the norm.
足下	あしもと, そっか	at one's feet, underfoot, one's step (as in "watch your step")., gait, pace, step., you, thou.
知り合い	しりあい	acquaintance.
牧場	ぼくじょう, まきば	farm (livestock), ranch (US), station (Aus, NZ)., pasture land, meadow, grazing land.
引き分け	ひきわけ	draw (in competition), tie game.
絞る	しぼる	to wring (towel, rag), to squeeze., to squeeze (fruit to extract juice), to press, to extract, to milk, to express milk., to rack (one's brains), to strain (one's voice)., to extort, to exploit., to chew out, to reprimand severely, to rake over the coals, to give a sound scolding, to tell someone off, to scold, to rebuke., to drill into, to train., to narrow down (one's focus), to whittle down., to gather up (curtain, etc.), to tighten (drawstring)., to stop down (lens)., to turn down (e.g. radio)., to bend (bow), to draw., to hold down, to constrict, to immobilize.
重体	じゅうたい	seriously ill, serious condition, critical state.
踏切	ふみきり	railway crossing, railroad crossing, train crossing, level crossing., starting line, scratch., determination., stepping over the edge of the ring.
街角	まちかど	street corner.
缶詰	かんづめ	packing (in cans), canning, canned goods, tin can., confining someone (e.g. so they can concentrate on work)., being stuck in a confined space.
逆さ	さかさ	reverse, inversion, upside down.
紅葉	こうよう, もみじ	autumn colours, fall colors, leaves changing color (colour)., leaves turning red, red leaves., leaves turning yellow, yellow leaves., (Japanese) maple (Acer japonicum)., venison.
白髪	しらが, はくはつ, しろかみ, しらかみ	white hair, grey hair, gray hair.
出入り口	でいりぐち	exit and entrance.
並行	へいこう	(going) side-by-side, abreast., concurrent, occurring together, at the same time., parallel.
百科事典	ひゃっかじてん	encyclopedia, encyclopaedia.
温まる	あたたまる, あったまる, ぬくまる	to warm oneself, to sun oneself, to warm up, to get warm.
改正	かいせい	revision, amendment, alteration.
強化	きょうか	strengthen, intensify, reinforce, solidify, enhancement.
交流	こうりゅう	(cultural) exchange, interchange, interaction, (inter-) mingling, (social, etc.) networking, intercourse., alternating current, AC.
構造	こうぞう	structure, construction.
姿勢	しせい	attitude, posture, stance, approach, carriage (of the body).
自ら	みずから	for one's self, personally.
自宅	じたく	one's home.
周辺	しゅうへん	circumference, outskirts, environs, around, in the area of, in the vicinity of., (computer) peripheral.
政党	せいとう	political party.
体制	たいせい	order, system, structure, set-up, organization, organisation.
対策	たいさく	measure, provision, step, countermeasure, counterplan, countermove.
段階	だんかい	grade, level, stage, class, phase, steps, order, gradation.
調整	ちょうせい	adjustment, regulation, coordination, reconciliation, tuning, fixing, tailoring.
長男	ちょうなん	eldest son (may be the only son), first-born son.
統一	とういつ	unity, consolidation, uniformity, unification, compatible.
方針	ほうしん	objective, plan, policy.
本部	ほんぶ	headquarters, head office, main office.
民間	みんかん	private, civilian, civil, popular, folk, unofficial.
民主	みんしゅ	democracy, popular sovereignty., democratic.
連合	れんごう	union, alliance, combination., RENGO (Japanese Trade Union Confederation).
延長	えんちょう	extension, elongation, prolongation, lengthening., Enchou era (923.4.11-931.4.26).
解散	かいさん	breakup, dissolution.
回答	かいとう	reply, answer.
開放	かいほう	open, throw open, liberalization, liberalisation.
観測	かんそく	observation.
基礎	きそ	foundation, basis.
基地	きち	base.
公共	こうきょう	public, community, public service, society, communal.
公式	こうしき	formality, formal, official., formula.
工事	こうじ	construction work, construction, work (related to construction, e.g. painting, concrete-pouring, etc.).
行方	ゆくえ	(one's) whereabouts., outcome.
国籍	こくせき	nationality.
国立	こくりつ	national.
資料	しりょう	materials, data, document.
自治	じち	self-government, autonomy., local (governmental) autonomy.
実績	じっせき	achievements, actual results, accomplishments, past results, track record.
実力	じつりょく	(real) ability, true strength, merit, efficiency, competency., arms, force.
受験	じゅけん	taking an examination (esp. school and university entrance).
就任	しゅうにん	inauguration, assumption of office.
集会	しゅうかい	meeting, assembly, gathering, congregation, convention, rally.
出場	しゅつじょう	(stage) appearance, performance., participation (e.g. in a tournament).
焦点	しょうてん	focus (e.g. photographic), focal point.
人事	じんじ	personnel affairs, human affairs, human resources, HR.
成立	せいりつ	coming into existence, arrangements, establishment, conclusion, completion., to come into existence, to be true, to hold (i.e. hold true).
整備	せいび	maintenance, servicing., putting in place, establishment, development, preparation, provision, outfitting.
狙い	ねらい	aim.
対立	たいりつ	confrontation, opposition, antagonism.
中間	ちゅうかん	middle, midway, interim.
直後	ちょくご	immediately following.
直前	ちょくぜん	just before.
通貨	つうか	currency.
停止	ていし, ちょうじ	suspension, interruption, stoppage, ban, standstill, halt, hang-up, deadlock, stalemate, abeyance., suspension of music, dance, etc. as a sign of mourning for a prominent person.
展開	てんかい	development, evolution, progressing, unfolding., expansion, spreading out, extending, deployment, building up.
南北	なんぼく	south and north.
日程	にってい	schedule, program, programme, agenda.
防止	ぼうし	prevention, check.
輸送	ゆそう	transport, transportation.
臨時	りんじ	temporary, special, extraordinary.
天皇	てんのう, すめらぎ, すめろぎ	Emperor of Japan.
少なくとも	すくなくとも	at least.
相互	そうご	mutual, reciprocal.
編集	へんしゅう	editing, compilation, editorial (e.g. committee).
為替	かわせ, かわし	money order, draft., exchange (e.g. foreign).
一定	いってい, いちじょう	fixed, settled, constant, definite, uniform, regularized, regularised, defined, standardized, standardised, certain, prescribed.
応援	おうえん	aid, assistance, help, reinforcement, rooting, barracking, support, cheering.
下車	げしゃ	alighting (from train, bus, etc.), getting off.
課税	かぜい	taxation.
過程	かてい	process, course, mechanism.
解放	かいほう	release, unleashing, liberation, emancipation, setting free., deallocation (of computer memory).
基盤	きばん	foundation, basis, base, footing.
期限	きげん	term, period, time frame., time limit, deadline, cutoff (date).
継続	けいぞく	continuation.
講師	こうし	lecturer.
合同	ごうどう	combination, union, incorporation, amalgamation, fusion., congruence.
撮影	さつえい	photography (still or motion), photographing, filming, shooting, (video) recording.
指定	してい	designation, specification, assignment, appointment, pointing at.
氏名	しめい, うじな	full name, identity.
私立	しりつ, わたくしりつ	private (establishment).
児童	じどう	children, juvenile.
勝負	しょうぶ	victory or defeat, match, contest, game, bout.
職場	しょくば	one's post, place of work, workplace.
新幹線	しんかんせん	bullet train (very high speed), Shinkansen.
申請	しんせい	application, request, petition.
制作	せいさく	work (film, book)., production, creation.
全力	ぜんりょく	all one's power, whole energy.
相撲	すもう, すまい	sumo wrestling., wrestler, rikishi.
追加	ついか	addition, supplement, append (e.g. to a file), appendix.
低下	ていか	fall, decline, lowering, deterioration, degradation.
電力	でんりょく	electric power.
東西	とうざい, ひがしにし	east and west., Orient and Occident, East and West., Ladies and Gentlemen!, Your attention, please!, roll-up, roll-up.
特定	とくてい	specific, special, particular.
年度	ねんど	fiscal year (usu. April 1 to March 31 in Japan), financial year., academic year, school year., product year.
売買	ばいばい	trade, buying and selling, trafficking (e.g. of humans, arms, drugs), dealing.
迫る	せまる, せる	to approach, to draw near, to be imminent., to press (someone for something), to urge, to compel.
発売	はつばい	sale, offering for sale, release (for sale), launch (product).
付近	ふきん	neighbourhood, neighborhood, vicinity, environs., approaching.
普及	ふきゅう	diffusion, spread, popularization, promulgation, familiarization.
部品	ぶひん	parts, accessories, components.
複数	ふくすう	several, plural, plurality, multiple.
本来	ほんらい	originally, primarily., essentially, naturally, by nature, in (and of) itself., proper, legal.
友好	ゆうこう	friendship.
来日	らいにち	arrival in Japan, coming to Japan, visit to Japan.
切っ掛け	きっかけ, キッカケ	chance, start, cue, excuse, motive, impetus, occasion.
意義	いぎ	meaning, significance.
移転	いてん	moving, relocation, transfer, demise.
演劇	えんげき	drama, theatre, theater, play.
火山	かざん	volcano.
過半数	かはんすう	majority.
解説	かいせつ	explanation, commentary, exposition, elucidation.
改造	かいぞう	remodeling, remodelling, restructuring., modding.
開会	かいかい	opening of a meeting.
学会	がっかい	scientific society, academic meeting, academic conference.
活躍	かつやく	activity (esp. energetic), great efforts, conspicuous service., to flourish, to participate actively, to play an active role.
感想	かんそう	impressions, thoughts.
原理	げんり	principle, theory, fundamental truth.
公害	こうがい	pollution, public nuisance, contamination.
項目	こうもく	(data) item, entry.
高級	こうきゅう	high class, high grade.
重点	じゅうてん	important point, lay stress on, colon, emphasis.
書店	しょてん	bookshop, bookstore.
助教授	じょきょうじゅ	assistant professor, associate professor.
商業	しょうぎょう	commerce, trade, business.
商社	しょうしゃ	trading company, firm.
小学生	しょうがくせい	elementary school student, primary school student, grade school student.
賞金	しょうきん	prize, monetary award.
森林	しんりん	forest, woods.
正	せい	(logical) true, regular., 10^40, ten thousand undecillion., original., positive, greater than zero.
正面	しょうめん	front, frontage, facade, main.
製作	せいさく	manufacture, production.
窓口	まどぐち	ticket window, teller window, counter., contact person, point of contact.
大学院	だいがくいん	graduate school.
短期	たんき	short term.
知人	ちじん	friend, acquaintance.
地帯	ちたい	area, zone, belt (of land).
竹	たけ	bamboo., middle (of a three-tier ranking system).
庁	ちょう	government office, agency, board.
長女	ちょうじょ	eldest daughter, first-born daughter.
定員	ていいん	fixed number of regular personnel, capacity (of boat, hall, aeroplane, airplane, etc.).
東洋	とうよう	Orient.
統計	とうけい	statistics.
特殊	とくしゅ	special, particular, peculiar, unique.
入社	にゅうしゃ	joining a company, getting a job with a company, entering a company.
農村	のうそん	agricultural community, farm village., rural.
発想	はっそう	idea, conception, way of thinking., expression.
反省	はんせい	reflection, reconsideration, introspection, meditation, contemplation., regret, repentance, remorse, being sorry.
標準	ひょうじゅん	standard, level, norm.
夫妻	ふさい	man and wife, married couple.
保健	ほけん	health preservation, hygiene, sanitation.
募集	ぼしゅう	recruiting, taking applications.
摩擦	まさつ	friction, rubbing, rubdown, chafe.
面積	めんせき	square measure, size (e.g. of land), area, surface.
予備	よび	preparation, preliminaries, reserve, spare.
先頭	せんとう	head, lead, vanguard, first.
中身	なかみ	contents, interior, substance, filling, (sword) blade.
羽	わ, ば, ぱ	counter for birds and rabbits.
育児	いくじ	childcare, nursing, upbringing.
一段	いちだん	more, much more, still more, all the more., step, rung, level, rank., paragraph, passage., Japanese verb group., first rank (in martial arts, etc.).
下旬	げじゅん	month (last third of).
回数	かいすう	number of times, frequency, count.
海洋	かいよう	ocean.
官庁	かんちょう	government office, government agency, authorities.
看板	かんばん	signboard, sign, billboard, hoarding, doorplate., draw, attraction, feature, highlight, spokesman, figurehead., reputation (of a shop)., appearance, look., closing time.
間もなく	まもなく	soon, before long, in a short time., (after verb) lacking time to ..., without time to ....
給与	きゅうよ	pay, salary, wages, allowance, grant, supply.
漁業	ぎょぎょう	fishing (industry).
競馬	けいば	horse racing.
形式	けいしき	form (as opposed to substance), formality., method, system, style., format, mode, appearance, form (something takes)., math expression.
芸能	げいのう	public entertainment, accomplishments, attainments.
血液	けつえき	blood.
公表	こうひょう	official announcement, proclamation.
工夫	くふう	scheme, device, scheming, devising, figuring out, coming up with, solving ingeniously., dedication to spiritual improvement (esp. through Zen meditation).
広場	ひろば	plaza, (public) square, piazza, forum, open space.
行事	ぎょうじ	event, function.
主役	しゅやく	leading part, leading actor (actress).
終了	しゅうりょう	end, close, termination.
商店	しょうてん	shop, small store, business, firm.
将棋	しょうぎ	shogi, Japanese chess, xianqi.
消極的	しょうきょくてき	negative, half-hearted, passive, unmotivated, pessimistic.
上下	じょうげ	top and bottom, high and low, above and below, upper and lower ends, up and down., going up and down, rising and falling, fluctuating., going and coming back., upper and lower classes, ruler and ruled, the government and the people., first and second volumes.
診断	しんだん	diagnosis, medical examination.
推定	すいてい	presumption, assumption., estimation.
宣伝	せんでん	publicity, advertisement, advertising, propaganda.
体重	たいじゅう	body weight, one's weight.
地点	ちてん	site, point on a map, spot.
中旬	ちゅうじゅん	middle of a month, second third of a month.
電波	でんぱ	electro-magnetic wave, radio wave., nonsense.
登場	とうじょう	entry (on stage), appearance (on screen)., entrance, introduction (into a market).
都心	としん	city centre (center) (esp. capital city), urban centre, heart of city a metropolis.
当日	とうじつ	appointed day, very day.
透明	とうめい	transparency, cleanness.
俳句	はいく	haiku, 17-mora poem, usu. in 3 lines of 5, 7 and 5 morae.
発電	はつでん	generation (e.g. power).
要旨	ようし	point, essentials, gist, summary, fundamentals.
例外	れいがい	exception.
率直	そっちょく	frankness, candour, candor, openheartedness, directness.
以後	いご	after this, from now on, hereafter., thereafter, since (verb) (after -te form of verb), after (time), since (then).
往復	おうふく	making a round trip, going and returning, coming and going., round-trip ticket, return ticket., correspondence, exchanging (letters)., socializing, visiting one another.
温泉	おんせん	spa, hot spring, onsen.
貨物	かもつ, かぶつ	cargo, freight., money or assets.
外部	がいぶ	the outside., external.
学科	がっか	study subject, course of study., department (university, etc.).
気配	けはい, きはい	indication, sign, hint, presence, trend., quotation (esp. stock market).
強気	つよき	confident, assured, self-assured, firm, strong, cocksure., bullish (e.g. market).
努める	つとめる	to endeavor (endeavour), to try, to strive, to make an effort, to exert oneself, to be diligent.
区域	くいき	limits, boundary, domain, zone, sphere, territory., area (e.g. in programming languages).
原稿	げんこう	manuscript, copy.
高層	こうそう	multistory, multistoried, high-rise, high, tall.
高度	こうど	altitude, height, elevation., advanced, sophisticated, high-grade, strong.
高等	こうとう	high class, high grade.
作者	さくしゃ	author, authoress, writer, composer, artist.
死体	したい	dead body, corpse, cadaver.
実用	じつよう	practical use, utility.
縮小	しゅくしょう	reduction, curtailment.
水面	すいめん, みなも	water's surface.
前後	ぜんご	front and rear, front and back, before and behind., before and after., order, context., consequences., inversion, reversion, getting out of order., co-occurring., around, about, approximately, nearly.
全身	ぜんしん	whole (body), full-length (e.g. portrait)., systemic.
彫刻	ちょうこく	carving, engraving, sculpture.
通勤	つうきん	commuting to work.
発	はつ	departure, departing (from ...), departing (at time ...)., sending, sent (by ...), sent (at ...)., engine., green dragon tile (mahjong)., counter for gunshots, bursts of gas, etc., counter for bullets, bombs, etc., counter for blows (punches).
判事	はんじ	judge, judiciary.
半島	はんとう	peninsula.
敷地	しきち	site, plot, lot, grounds.
父母	ふぼ, ちちはは, ててはは, かぞいろは, ぶも, かぞいろ	father and mother, parents.
噴火	ふんか	eruption.
文芸	ぶんげい	literature, art and literature, belles-lettres.
放る	ほうる, ほる	to throw, to toss, to fling., to throw away, to discard., to neglect, to abandon, to leave alone, to give up on, to leave undone, to leave unfinished.
方面	ほうめん	direction, district, area., field (e.g. of study).
夜間	やかん	at night, nighttime.
役所	やくしょ	government office, public office.
欄	らん	column of text (e.g. in a newspaper)., field (in a form, web page, etc.).
列島	れっとう	archipelago, chain of islands.
銅	どう, あかがね	copper (Cu).
果たして	はたして	as was expected, just as one thought, sure enough, as a result., really? (in questions), ever?.
膨大	ぼうだい	huge, vast, enormous, colossal, extensive, multitudinous., swelling, expansion.
本の	ほんの	mere, only, just, not even (with negative verb).
安易	あんい	easy, simple., easy-going.
胃	い	stomach., Chinese "stomach" constellation (one of the 28 mansions).
一流	いちりゅう	first-class, top grade, foremost, top-notch, leading., characteristic, peculiar, unique., school (e.g. of a performance art)., one flag, one banner, one streamer.
架空	かくう	aerial, overhead., fiction, fictitious, imaginary, fanciful.
回転	かいてん	rotation (usu. around something), revolution, turning.
外科	げか	surgery., department of surgery (hospital, etc.).
楽器	がっき	musical instrument.
休業	きゅうぎょう	closed (e.g. store), business suspended, shutdown, holiday.
苦情	くじょう	complaint, troubles, objection, grievance.
空中	くうちゅう	sky, air.
計	けい	plan., meter, measuring device., (in) total, total (of).
原料	げんりょう	raw materials.
限度	げんど	limit, bounds.
古典	こてん	old book, classics, classic.
公正	こうせい	justice, fairness, impartiality.
再三	さいさん	again and again, repeatedly.
産地	さんち	producing area.
時速	じそく	speed (per hour).
自衛	じえい	self-defense, self-defence.
重量	じゅうりょう	weight., heavyweight boxer.
出張	しゅっちょう	official tour, business trip.
書道	しょどう	calligraphy.
姓	せい, しょう, そう	surname, family name., hereditary title (used in ancient Japan to denote rank and political standing).
成分	せいぶん	ingredient, component, composition.
生存	せいぞん	existence, being, survival., to exist, to live, to survive.
先端	せんたん	pointed end, tip, fine point, spearhead, cusp, vanguard, advanced, leading edge, apex (of a curve).
全般	ぜんぱん	(the) whole, universal, wholly, general.
素直	すなお	obedient, meek, docile, unaffected., honest, frank, upfront (about one's feelings).
倉庫	そうこ	storehouse, warehouse, godown.
相変わらず	あいかわらず	as ever, as usual, the same, still.
体系	たいけい	system, organization, organisation, architecture.
体操	たいそう	gymnastics, physical exercises, calisthenics.
大工	だいく	carpenter.
通知	つうち	notice, notification, report, posting.
通訳	つうやく	interpretation (i.e. oral translation), interpreter.
特色	とくしょく	characteristic, feature, idiosyncrasy, personal colour., spot color (in printing).
矛盾	むじゅん	contradiction, inconsistency.
面接	めんせつ	interview.
木材	もくざい	lumber, timber, wood.
役者	やくしゃ	actor, actress.
有無	うむ, ゆうむ	existence or nonexistence, presence or absence., consent or refusal, yes or no., flag indicator, presence or absence marker.
有料	ゆうりょう	toll, fee, charge, admission-paid.
幼児	ようじ	infant, baby, child., child over 1 but not yet of school age.
幼稚園	ようちえん	kindergarten.
用語	ようご	term, terminology., wording, choice of words, phraseology.
寮	りょう	hostel, dormitory.
広げる	ひろげる	to spread, to extend, to expand, to enlarge, to widen, to broaden., to unfold, to open, to unroll, to unwrap., to scatter about, to spread around., to make flourish, to cause to prosper.
生る	なる	to bear fruit.
持ち	もち	hold, charge, keep possession, in charge., wear, durability, life, draw., usage.
過失	かしつ	error, blunder, accident., fault, defect.
過剰	かじょう	excess, over-.
活力	かつりょく	vitality, energy, dynamism.
強引	ごういん	overbearing, coercive, pushy, forcible, high-handed.
教養	きょうよう	cultivation, refinement, culture, education.
見学	けんがく	inspection, study by observation, field trip.
見出し	みだし	heading, headline, title, caption., index., headword.
見送る	みおくる	to see off (e.g. to the station, an airport, etc.), to escort (e.g. home), to farewell., to see out, to send off., to let pass, to wait and see, to continue (e.g. in legal contexts)., to let a pitch go by (baseball), to watch a batted ball go into the stands.
見舞う	みまう	to ask after (health), to visit.
元日	がんじつ, がんにち	New Year's Day.
後輩	こうはい	junior (at work, school, etc.), younger people, younger student.
工芸	こうげい	industrial arts, craft.
広さ	ひろさ	extent.
校舎	こうしゃ	school building.
行	ぎょう	line (i.e. of text), row, verse., carya (austerities)., samskara (formations)., running script (a semi-cursive style of kanji).
酸性	さんせい	acidity., acidic.
司会	しかい	chairmanship, leading a meeting, presenter, host.
寺院	じいん	temple.
執筆	しっぴつ	writing (e.g. as a profession).
実感	じっかん	real feeling, actual feeling., to actually feel, to have a real feeling (that ...), to experience personally.
手前	てまえ	before, this side., one's standpoint, one's appearance., we., you.
神話	しんわ	myth, legend.
親類	しんるい	relation, kin.
性能	せいのう	ability, performance, efficiency.
創作	そうさく	production, literary creation, work.
増大	ぞうだい	enlargement, increase.
造船	ぞうせん	shipbuilding.
測定	そくてい	measurement.
団地	だんち	multi-unit apartments.
中年	ちゅうねん	middle-age, middle age, midlife, one's middle years.
頂点	ちょうてん	top, summit.
殿	どの	form of address used for official letters and business letters, and in letters to inferiors, Mr.
派手	はで	showy, loud, gay, flashy, gaudy.
皮膚	ひふ, ひフ	skin.
評論	ひょうろん	criticism, critique.
別荘	べっそう	holiday house, villa.
崩れる	くずれる	to collapse, to crumble.
盆	ぼん	O-Bon, Bon Festival, Lantern Festival, Festival of the Dead., tray., family, household.
目安	めやす	criterion, standard, yardstick, reference, aim., rough estimate, approximation.
役人	やくにん	government official.
夕刊	ゆうかん	evening paper.
利害	りがい	advantages and disadvantages, interest.
貸し出し	かしだし	lending, loaning.
続々	ぞくぞく	successively, one after another.
水産	すいさん	aquatic products, fisheries.
井戸	いど	water well.
一応	いちおう	once, tentatively, in outline, for the time being, just in case, so far as it goes.
応用	おうよう	application, put to practical use.
恩恵	おんけい	grace, favor, favour, blessing, benefit.
加速	かそく	acceleration, speeding up.
角度	かくど	angle.
瓦	かわら	roof tile.
寄せる	よせる	to come near, to let someone approach., to bring near, to bring together, to collect, to gather., to deliver (opinion, news, etc.), to send (e.g. a letter), to contribute, to donate., to let someone drop by., to add (numbers)., to have feelings for (love, good will, trust, etc.)., to rely upon for a time, to depend on., to use as a pretext., to put aside., to press, to push, to force.
儀式	ぎしき	ceremony, rite, ritual, service.
境界	きょうかい	boundary.
厳重	げんじゅう	strict, rigour, rigor, severe, firm, strong, secure.
娯楽	ごらく	pleasure, amusement.
攻める	せめる	to attack, to assault, to assail.
在学	ざいがく	(enrolled) in school.
使い	つかい	errand, mission, going as envoy., messenger, bearer, errand boy, errand girl., familiar spirit., use, usage, user, trainer, tamer, charmer.
私鉄	してつ	private railway.
寿命	じゅみょう	life span.
集合	しゅうごう	gathering, assembly, meeting., set.
重ねる	かさねる	to pile up, to put something on another, to heap up, to add, to repeat.
純粋	じゅんすい	pure, true, genuine, unmixed.
巡査	じゅんさ	police, policeman.
書籍	しょせき	book, publication.
上旬	じょうじゅん	first 10 days of month.
職人	しょくにん	worker, mechanic, artisan, craftsman.
身分	みぶん	social position, social status.
性別	せいべつ	distinction by sex, sex, gender.
清掃	せいそう	cleaning.
接近	せっきん	getting closer, drawing nearer, approaching., being not much different, being near (age, skill, etc.)., becoming close (i.e. friendly), becoming intimate.
素人	しろうと, しろと, しらびと	amateur, layman, ordinary person, novice., respectable woman (not a prostitute, hostess, geisha, etc.).
総理大臣	そうりだいじん	prime minister (as the head of a cabinet government), premier.
地味	じみ	plain, simple, subdued, sober.
南極	なんきょく	South Pole., the Antarctic, Antarctica.
平日	へいじつ, ひらび	weekday, ordinary days (i.e. non-holiday)., kanji radical 73.
平野	へいや	plain, open field.
歩	ほ	step, stride., counter for steps.
埋める	うめる	to bury (e.g. in the ground)., to fill up (e.g. audience fills a hall), to fill (a seat, a vacant position), to fill out., to plug gaps, to stop a gap., to make amends, to cover up for something., to put cold water in a bath., to cover, to scatter something over.
満員	まんいん	full house, no vacancy, sold out, standing room only, full (of people), crowded.
用途	ようと	use, usefulness, utility, service, purpose.
理科	りか	science.
録音	ろくおん	(audio) recording.
手帳	てちょう	notebook, memo pad, (pocket) diary., certificate., identification card.
響き	ひびき	echo, reverberation., sound (esp. the distinctive sound of an object or activity, e.g. rain, gun, gallop, drum), noise., quality of a sound (e.g. a fine phrase, clear voice, resonant bell), feeling of a sound, emotion or feeling inspired by something heard or read.
下町	したまち	low-lying part of a city (usu. containing shops, factories, etc.)., Shitamachi (low-lying area of eastern Tokyo near Tokyo Bay, inc. Asakusa, Shitaya, Kanda, Fukugawa, Honjo, Nihonbashi, Kyobashi and surrounds).
何とも	なんとも, なにとも	quite, really, very, extremely., nothing, not a bit, not at all.
花火	はなび	fireworks.
課程	かてい	course, curriculum.
確率	かくりつ	probability, likelihood, chances.
学年	がくねん	year in school, grade in school.
活字	かつじ	printing type, movable type., printed text, print.
気圧	きあつ	atmospheric pressure.
客席	きゃくせき	guest seating (e.g. theater, stadium), passenger seat (e.g. taxi)., audience.
系統	けいとう	system., lineage, ancestry, family line., group (e.g. of colors) (colours), family (e.g. of languages), party, school (of thought)., close (evolutionary) relationship., a population sharing a common ancestor (in genetics), strain (e.g. bacterial).
血圧	けつあつ	blood pressure.
県庁	けんちょう	prefectural office.
肯定	こうてい	positive, affirmation.
高める	たかめる	to raise, to lift, to boost, to enhance.
四季	しき	four seasons.
紙幣	しへい	paper money, notes, bills.
紫	むらさき	purple, violet., Lithospermum erythrorhizon (species of gromwell)., type of soy sauce.
祝日	しゅくじつ	national holiday, public holiday.
女房	にょうぼう, にょうぼ, にゅうぼう	wife (esp. one's own wife)., court lady, female court attache, woman who served at the imperial palace.
勝敗	しょうはい	victory or defeat, issue (of battle), outcome.
上り	のぼり	ascent, climbing, ascending (path), climb., up-train (e.g. going to Tokyo)., northward (towards Tokyo).
上級	じょうきゅう	advanced level, high grade, senior.
心身	しんしん, しんじん	mind and body.
神様	かみさま	God.
水曜	すいよう	Wednesday.
性質	せいしつ	nature, property, disposition.
接する	せっする	to touch, to come in contact with, to border on, to adjoin, to be adjacent, to be close., to receive (e.g. visitor), to attend to, to serve, to take care of, to look after, to deal with, to see., to receive (news), to get, to hear., to encounter, to come across., to be tangent to., to make touch, to bring into contact with, to bring adjacent to, to bring close, to connect.
線路	せんろ	line, track, roadbed.
相違	そうい	difference, discrepancy, variation.
滝	たき	waterfall.
中世	ちゅうせい	Middle Ages (in Japan esp. the Kamakura and Muromachi periods ), medieval times, mediaeval times.
定価	ていか	list price, regular price, established price.
点数	てんすう	marks, points, score, runs, number of items, credits.
投書	とうしょ	letter to the editor, letter from a reader, contribution.
童話	どうわ	fairy-tale.
日時	にちじ	date and time.
表紙	ひょうし	front cover, binding, (book) cover., appearing on the cover of a magazine.
物語る	ものがたる	to tell, to indicate.
包丁	ほうちょう	kitchen knife, carving knife.
名作	めいさく	masterpiece.
名刺	めいし	business card.
網	あみ	net, netting., web.
役目	やくめ	duty, business, role.
薬品	やくひん	medicine, chemicals.
粒	つぶ, つび, つぼ	grain, bead, drop., counter for small round objects including grains, seeds, pills, drops.
冷凍	れいとう	freezing, cold storage, refrigeration.
弟子	でし, ていし	pupil, disciple, adherent, follower, apprentice, young person, teacher's student-helper.
一々	いちいち	one-by-one, separately., every single, each and every, without omission, fully, in detail.
別々	べつべつ	separately, individually.
分かれる	わかれる	to branch, to fork, to diverge., to separate, to split, to divide., to disperse, to scatter.
我が	わが	my, our, one's own.
圧縮	あっしゅく	compression, condensation, constriction, compaction.
英文	えいぶん	sentence in English, article in English, English text., English literature (study of).
液体	えきたい	liquid, fluid.
殴る	なぐる	to strike, to hit.
可決	かけつ	approval, adoption (e.g. motion, bill), passage.
家屋	かおく	house, building.
改める	あらためる	to change, to alter, to revise, to replace., to reform, to correct, to mend, to improve., to examine, to check, to inspect., to do properly, to do formally.
貝	かい	shell, shellfish.
拡張	かくちょう	expansion, extension, enlargement, escape, ESC.
学力	がくりょく	scholarly ability, scholarship, knowledge, literary ability.
間隔	かんかく	space, interval, SPC.
器具	きぐ	utensil, apparatus, implement, device, gadget.
規律	きりつ	order, observance, discipline., rules, law, regulations.
群れ	むれ	group, crowd, flock, herd, bevy, school, swarm, cluster (e.g. of stars), clump, pack (e.g. of dogs).
限り	かぎり	limit, limits, bounds., degree, extent, scope., as far as possible, as much as possible, to the best of one's ability, very much., unless (after neg. verb)., the end, the last., as long as, only.
碁	ご	go (board game of capturing territory).
公務	こうむ	official business, public business.
綱	つな	rope., grand champion's braided belt.
行列	ぎょうれつ	line, procession., matrix.
号	ごう	number, edition, make, model, issue, part of that group., sobriquet, pen-name.
合理	ごうり	rational.
紺	こん	navy blue, deep blue.
催し	もよおし	event, festivities, function, social gathering, auspices, opening, holding (a meeting).
子孫	しそん	descendants, posterity, offspring.
実習	じっしゅう	practice, practising, training (esp. practical and hands-on), drill.
社説	しゃせつ	editorial, leading article.
弱点	じゃくてん	weak point, weakness, shortcoming, defect, flaw, sore spot, tender spot.
汁	しる, つゆ	juice, sap., soup, broth., (dipping) sauce.
循環	じゅんかん	circulation, rotation, cycle.
飾り	かざり	decoration.
真っ暗	まっくら	total darkness, pitch dark., bleak future, poor prospects.
水素	すいそ	hydrogen (H).
水分	すいぶん	water, liquid, fluid, moisture, humidity, sap, juice.
杉	すぎ, スギ	Japanese cedar (Cryptomeria japonica).
税関	ぜいかん	customs house.
洗剤	せんざい	detergent, washing material.
全集	ぜんしゅう	complete works.
争う	あらそう	to compete, to contest, to contend., to quarrel, to argue, to dispute, to be at variance, to oppose., (usu. in negative form) to deny (e.g. evidence).
属する	ぞくする	to belong to, to come under, to be affiliated with, to be subject to.
太鼓	たいこ	drum.
地面	じめん	ground, earth's surface.
中途	ちゅうと	in the middle, half-way.
電池	でんち	battery.
内科	ないか	internal medicine, i.e. treatment by medical procedures rather than surgical procedures., department of internal medicine (hospital, etc.).
筆者	ひっしゃ	writer (often in self-reference), author.
文献	ぶんけん	literature, books (reference), document.
閉会	へいかい	closure (of a ceremony, event, meeting, etc.).
包装	ほうそう	packing, wrapping.
名所	めいしょ, などころ	famous place., name of a part (of an instrument, etc.)., name and address.
目下	めした	subordinate, subordinates, inferior, inferiors, junior.
直径	ちょっけい	diameter.
満点	まんてん	perfect score, full marks., extremely, very, quite.
生き生き	いきいき	vividly, lively.
宴会	えんかい	party, banquet.
屋外	おくがい	outdoors, alfresco.
科	か	department, section, faculty, school, arm., course (of study), branch of study, specialization., (taxonomical) family.
乾燥	かんそう	dryness, aridity, insipidity, dehydration, desiccation.
感激	かんげき	deep emotion, impression, inspiration.
鑑賞	かんしょう	appreciation (e.g. of art), aesthetic sense.
間接	かんせつ	indirection, indirectness.
区分	くぶん	division, section, demarcation, partition, segmentation, subdivision, (traffic) lane, compartment, classification, sorting.
見直す	みなおす	to look again., to get a better opinion of.
現に	げんに	actually, really.
山林	さんりん	mountain forest, forest on a mountain, montane forest., mountains and forest.
車庫	しゃこ	garage, car shed, carport.
重力	じゅうりょく	gravity.
出勤	しゅっきん	attendance (at work), being at work, presence (in the office), going to work, reporting for work.
消化	しょうか	digestion., thorough understanding., selling accumulated (excess) products, dealing with a large amount of work., losing one's form and turning into something else.
鐘	かね	bell (often a large hanging bell), chime.
食器	しょっき	tableware.
侵入	しんにゅう	penetration, invasion, raid, aggression, trespass.
先祖	せんぞ	ancestor.
大小	だいしょう	sizes (various), large and small., daisho (matched pair of long and short swords)., large and small drums., long months and short months.
直線	ちょくせん	straight line.
停電	ていでん	power outage, electricity outage, blackout, failure of electricity supply.
動作	どうさ	action, movements, motions, bearing, behaviour, behavior, execution, actuation, operation, manners.
破片	はへん	fragment, splinter, broken piece.
縛る	しばる	to tie, to bind.
美容	びよう	beauty of figure or form.
民謡	みんよう	folk song, popular song.
無数	むすう	countless number, infinite number, innumerable.
名物	めいぶつ	famous product, special product, speciality, specialty.
郵送	ゆうそう	mailing.
余計	よけい	too many, too much, excessive, superfluous, superabundant, extra, spare, surplus., unnecessary, needless, uncalled-for, otiose., abundantly, excessively, needlessly, all the more.
要領	ようりょう	point, gist, essentials, tenets, outline., knack, trick, the ropes.
引っ越し	ひっこし	moving (dwelling, office, etc.), changing residence.
見つめる	みつめる	to stare at, to gaze at, to look hard at, to watch intently, to fix one's eyes on.
園芸	えんげい	horticulture, gardening.
温室	おんしつ	greenhouse, hothouse, conservatory, glasshouse.
果実	かじつ	fruit, nut, berry.
改札	かいさつ	examination of tickets., ticket gate, ticket barrier.
灰色	はいいろ	grey, gray, ashen.
殻	から	shell, husk, hull, pod, chaff.
休養	きゅうよう	rest, break, recreation.
傑作	けっさく	masterpiece, best work., amusing blunder, funny mistake, boner.
月給	げっきゅう	monthly salary.
謙虚	けんきょ	modesty, humility.
効力	こうりょく	effect, efficacy, validity, potency.
口実	こうじつ	excuse, pretext.
孝行	こうこう	filial piety.
採点	さいてん	marking, grading, scoring.
三角	さんかく	triangle, triangular.
手入れ	ていれ	repairs, maintenance, tending, trimming, grooming., crackdown, (police) raid.
出入り	でいり, ではいり	in and out, coming and going, free association, income and expenditure, debits and credit.
小遣い	こづかい, こずかい	pocket money, spending money, pin money, allowance.
唇	くちびる	lips.
狙う	ねらう	to aim at.
葬式	そうしき	funeral.
題名	だいめい	title.
超過	ちょうか	excess, being more than.
通路	つうろ	passage, pathway, roadway, avenue, aisle.
盗難	とうなん	theft, robbery.
峠	とうげ	ridge, (mountain) pass, difficult part.
半径	はんけい	radius.
分布	ぶんぷ	distribution, dissemination, allocation.
望遠鏡	ぼうえんきょう	telescope.
墨	すみ	sumi, India ink, Chinese ink, ink stick, ink-cake., squid ink, octopus ink., carpenter's inking string.
枚数	まいすう	the number of flat things., win-loss difference which influences the ranking of wrestlers.
鈴	すず, りん, れい	bell (often globular).
箇所	かしょ	passage, place, point, part.
反映	はんえい	reflection (light, image, situation, attitude, etc.), reflecting., influence, application (e.g. of an update).
以降	いこう	on and after, as from, hereafter, thereafter, since.
応接	おうせつ	reception.
応対	おうたい	receiving, dealing with.
下降	かこう	downward, descent, fall, drop, subsidence.
垣根	かきね	hedge, fence.
危うい	あやうい	dangerous, risky, hazardous, perilous, precarious., in danger, in jeopardy, critical, grave, at risk., uncertain, unreliable, insecure, unsteady, doubtful., close (i.e. a close call), narrow.
記号	きごう	symbol, code, sign, notation.
漁師	りょうし	fisherman.
極	ごく	quite, very., 10^48, quindecillion.
刻む	きざむ	to mince, to cut fine, to chop up, to hash, to shred., to carve, to engrave, to chisel, to notch., to tick away (time), to record the passing moments., to etch (into one's mind), to remember distinctly.
刺身	さしみ	sashimi (raw sliced fish, shellfish or crustaceans).
実例	じつれい	example, illustration, precedent.
真っ先	まっさき	the head, the foremost, beginning, the very front.
酢	す	vinegar.
水着	みずぎ	bathing suit, swimsuit, swimmers.
地名	ちめい	place name.
頭脳	ずのう	head, brains, intellect.
配る	くばる	to distribute, to deliver, to deal (cards).
皮肉	ひにく	cynicism, sarcasm, irony, satire.
風船	ふうせん	balloon (esp. small, toy variety).
分類	ぶんるい	classification, categorization, sorting.
兵隊	へいたい	soldier, sailor.
方言	ほうげん	dialect.
無限	むげん	infinite.
毛皮	けがわ, もうひ	fur, skin, pelt., kanji "fur" radical.
力強い	ちからづよい	powerful, strong, forceful, vigorous., reassuring, encouraging.
武士	ぶし, ぶふ, もののふ	warrior, samurai.
両側	りょうがわ, りょうそく	both sides.
書留	かきとめ	registered mail., registration (e.g. of mail), writing down, putting on record, recording, making a note of.
並木	なみき	roadside tree, row of trees.
日差し	ひざし	sunlight, rays of the sun.
案外	あんがい	unexpectedly.
花嫁	はなよめ	bride.
釜	かま	iron pot, kettle.
月末	げつまつ, つきずえ	end of the month.
脂	あぶら	fat, tallow, lard, grease.
湿度	しつど	level of humidity.
斜め	ななめ, なのめ	slanting, tilted, sloping, diagonal, oblique., unusual, slanted (view of the world), bad (mood).
煮る	にる	to boil, to simmer, to stew, to seethe.
乗車	じょうしゃ	taking a train, bus, etc., entraining.
水平	すいへい	level, horizontality.
西暦	せいれき	Christian Era, CE, anno domini, AD.
接続	せつぞく	connection, attachment, union, join, joint, link., changing trains., conjunction.
測量	そくりょう	measurement, surveying.
対照	たいしょう	contrast, antithesis, comparison.
調節	ちょうせつ	regulation, adjustment, control.
長所	ちょうしょ	strong point, merit, virtue, advantage.
通帳	つうちょう	passbook, bankbook.
電流	でんりゅう	electric current.
灯油	とうゆ	lamp oil, kerosene.
反	はん	anti-., antithesis., fanqie, traditional Chinese spelling system in which two characters are used: the first one for the onset, the second one for rhyme and tone.
標識	ひょうしき	sign, mark, flag.
分解	ぶんかい	disassembly, dismantling, disaggregating, analysis, disintegrating, decomposing, degrading., factorization., decomposition, resolution., deblocking.
法則	ほうそく	law, rule.
遊園地	ゆうえんち	amusement park.
留守番	るすばん	care-taking, house-sitting, house-watching., caretaker, house-sitter.
真っ白	まっしろ, ましろ	pure white.
運河	うんが	canal, waterway.
解答	かいとう	answer, solution.
絵の具	えのぐ	colors, colours, paints.
各自	かくじ	individual, each.
驚かす	おどろかす	to surprise, to frighten, to create a stir.
権	けん	right (to do something)., authority, power.
口紅	くちべに	lipstick.
香水	こうすい	perfume.
恨み	うらみ	resentment, grudge, malice, bitterness., matter for regret, regret.
削除	さくじょ	elimination, cancellation, deletion, erasure, DEL (key).
持参	じさん	bringing, taking, carrying.
次ぐ	つぐ	to rank next to, to come after.
受話器	じゅわき	(telephone) receiver.
深まる	ふかまる	to deepen, to heighten, to intensify.
親指	おやゆび	thumb.
積む	つむ	to pile up, to stack., to load (car, ship, etc.), to pack., to acquire, to accumulate.
祖先	そせん	ancestor.
素質	そしつ	character, qualities, genius, the makings of.
売店	ばいてん	shop, stand.
鉢	はち	bowl, pot, basin., flowerpot., crown, brainpan.
免税	めんぜい	tax exemption, duty exemption.
薬局	やっきょく	pharmacy, chemist (shop), drugstore.
余る	あまる	to remain, to be left over, to be in excess, to be too many.
締め切る	しめきる	to close up, to shut up (e.g. behind doors), to cut off (e.g. because a deadline has expired).
叔父	おじ, しゅくふ	uncle (younger than one's parent).
岬	みさき	cape (on coast).
下る	くだる	to descend, to go down, to come down., to be handed down (of an order, judgment, etc.)., to pass (of time)., to surrender, to capitulate., (often in neg. form) to be less than, to be inferior to., to have the runs, to have diarrhea.
下水	げすい	drainage, ditch, gutter, sewerage., sewage, black water.
乾電池	かんでんち	dry cell, battery.
観念	かんねん	idea, notion, conception., sense (e.g. of duty)., resignation, preparedness, acceptance., observation and contemplation.
光線	こうせん	beam, light ray.
慌てる	あわてる	to become confused (disconcerted, disorganized, disorganised), to be flustered, to panic., to be in a hurry, to rush.
校庭	こうてい	schoolyard, campus.
差し引き	さしひき	deduction, subtraction, balance., ebb and flow, rise and fall.
算数	さんすう	arithmetic.
実物	じつぶつ	real thing, original, actual.
写る	うつる	to be photographed, to be projected.
車掌	しゃしょう	(train) conductor.
車輪	しゃりん	(car) wheel.
重役	じゅうやく, おもやく	company director, top management, high executive, (person with) heavy responsibilities.
賞品	しょうひん	prize, trophy.
増減	ぞうげん	increase and decrease, fluctuation.
代名詞	だいめいし	pronoun., synonym, classic example, pattern, byword, representative.
地質	ちしつ	geological features.
停車	ていしゃ	stopping (e.g. train).
田植え	たうえ	rice planting.
虹	にじ	rainbow.
発揮	はっき	exhibition, demonstration, show, display, manifestation.
容積	ようせき	capacity, volume.
丼	どんぶり, どん	porcelain bowl., bowl of rice with food on top.
浴衣	ゆかた, よくい	yukata (light cotton kimono worn in the summer or used as a bathrobe).
植木	うえき	garden shrubs, trees, potted plant.
建つ	たつ	to be erected, to be built.
換気	かんき	ventilation.
詰まる	つまる	to be packed (with), to be full (space, schedule, etc.)., to be blocked (road, pipe, etc.), to be clogged, to be plugged up., to shorten (width, interval, etc.), to shrink (shirt, word form, etc.), to narrow., to be at a loss, to be hard pressed., to end up, to be settled., to become a geminate consonant., to hit the ball near the handle of the bat.
献立	こんだて	menu, bill of fare., program, programme, schedule.
原始	げんし	origin, primeval.
公衆	こうしゅう	the public, general public.
歯車	はぐるま	gear, cog-wheel.
社会科学	しゃかいかがく	social science.
垂直	すいちょく	vertical, perpendicular.
随筆	ずいひつ	essays, miscellaneous writings, literary jottings.
生長	せいちょう	growth, increment.
赤道	せきどう	equator.
瞳	ひとみ	pupil (of eye)., eye.
日の出	ひので	sunrise.
日帰り	ひがえり	day trip.
能率	のうりつ	efficiency., moment (i.e. magnetic moment).
筆記	ひっき	(taking) notes, copying.
膨らむ	ふくらむ	to expand, to swell (out), to get big, to become inflated.
乱暴	らんぼう	rude, violent, rough, lawless, unreasonable, reckless.
和服	わふく	Japanese clothes.
残らず	のこらず	all, entirely, completely, without exception.
英和	えいわ	English-Japanese (e.g. dictionary).
格別	かくべつ, かくべち	particular, special, exceptional, especial., particularly, especially, exceptionally.
曲線	きょくせん	curve.
金魚	きんぎょ	goldfish.
郡	ぐん, こおり	district, county., district (of 2-20 50-home neighbourhoods or townships, in the ritsuryo period).
顕微鏡	けんびきょう	microscope.
鉱物	こうぶつ	mineral.
磁石	じしゃく, じせき	magnet., compass.
自然科学	しぜんかがく	natural science.
湿気	しっけ, しっき	moisture, humidity, dampness.
手首	てくび	wrist.
出迎え	でむかえ	meeting, reception.
序	ついで	opportunity, occasion.
消毒	しょうどく	disinfection, sterilization, sterilisation.
吹雪	ふぶき	snow storm, blizzard.
盛る	もる	to serve (food, etc.), to dish out., to fill up, to pile up, to heap., to prescribe, to administer, to dose out., to put into (e.g. information in a report)., to mark out (e.g. scale), to graduate (e.g. thermometer)., to exaggerate, to apply heavy makeup.
貸し	かし	loan, lending., favor, favour, debt, obligation., creditor, method of lending, credit side.
調味料	ちょうみりょう	flavoring (e.g. salt, sugar, soy sauce, vinegar, etc.), seasoning.
直通	ちょくつう	direct communication.
定期券	ていきけん	commuter pass, season ticket.
標本	ひょうほん	example, specimen, sample.
不規則	ふきそく	irregularity, unsteadiness, disorderly.
不通	ふつう	suspension, interruption, stoppage, tie-up, cessation.
浮かべる	うかべる	to float., to express, to look (sad, glad)., to think, to imagine, to remember.
文体	ぶんたい	literary style.
片道	かたみち	one-way (trip).
北極	ほっきょく	North Pole., the Arctic.
餅	もち, もちい, かちん, あも	sticky rice cake.
万歳	ばんざい, ばんぜい	crying "banzai" (or raising one's hands in the banzai gesture)., something worthy of celebration., giving up., banzai (a celebratory cheer), hurrah (hooray, hurray).
王女	おうじょ, おうにょ	princess.
家主	やぬし, いえぬし, いえあるじ	landlord, landlady., house owner, home owner, head of the household.
機関車	きかんしゃ	locomotive, engine.
見本	みほん	sample, specimen, pattern., model, example.
削る	けずる	to shave (wood or leather), to sharpen, to plane, to whittle, to pare, to scrape off., to shave off (e.g. a budget, expenses, a salary, etc.), to curtail, to cut down., to cross out, to reduce, to curtail, to remove, to erase, to delete.
索引	さくいん	index, indices, indexes.
雑音	ざつおん	noise (jarring, grating)., gossip, irresponsible criticism.
刺す	さす	to pierce, to stab, to prick, to stick, to thrust., to sting, to bite., to sew, to stitch, to embroider., to pole (a boat)., to catch (with a limed pole)., to put (a runner) out, to pick off.
順序	じゅんじょ	order, sequence, procedure.
床の間	とこのま	tokonoma (alcove where art or flowers are displayed).
心得る	こころえる	to know, to understand, to be aware of, to regard as, to take for., to consent, to agree.
図形	ずけい	figure, shape, graphic.
正門	せいもん	main gate, main entrance.
伝わる	つたわる	to be handed down, to be introduced, to be transmitted, to be circulated, to go along, to walk along.
電柱	でんちゅう	telephone pole, telegraph pole, lightpole.
奴	やつ, しゃつ	fellow, guy, chap., thing, object., (derogatory or familiar) he, she, him, her.
日課	にっか	daily lesson, daily work, daily routine.
日用品	にちようひん	daily necessities.
文脈	ぶんみゃく	context.
問答	もんどう	questions and answers, dialogue.
干す	ほす	to air, to dry, to desiccate., to drain (off)., to drink up., to deprive of a role, job, etc. (usu. in the passive).
蚊	か	mosquito.
隔てる	へだてる	to separate (by distance, time, etc.), to isolate, to partition, to divide., to interpose, to have between., to alienate, to estrange.
荒れる	あれる	to be stormy, to be rough., to be ruined, to fall into ruin., to be in a bad temper, to lose one's temper.
座敷	ざしき	tatami room, tatami mat room, formal Japanese room., dinner party in a tatami room.
材木	ざいもく	lumber, timber.
生年月日	せいねんがっぴ	birth date.
大通り	おおどおり	main street.
電球	でんきゅう	light bulb.
当番	とうばん	being on duty.
不運	ふうん	unlucky, misfortune, bad luck, fate.
文房具	ぶんぼうぐ	stationery.
坊さん	ぼうさん	Buddhist priest, monk., boy.
乾杯	かんぱい	toast, drink (in celebration or in honor of something)., drinking one's glass dry., cheers.
芯	しん	wick, marrow, staple (for stapler), (pencil) lead, stuffing, pith., core, heart, centre, center.
快晴	かいせい	clear weather, cloudless weather, good weather.
看病	かんびょう	nursing (a patient).
苦心	くしん	pain, trouble, anxiety, diligence, hard work.
修繕	しゅうぜん	repair, mending.
出来上がり	できあがり	finish, completion, ready, made for, cut out.
初歩	しょほ	basics, rudiments, elements, ABCs of ....
小指	こゆび	little finger, pinky., little toe.
蒸す	むす	to steam, to poultice, to be sultry.
水蒸気	すいじょうき	water vapour, water vapor, steam.
寸法	すんぽう	measurement, size, extent, dimension., plan, intention, arrangement, schedule.
早口	はやくち, はやぐち	fast-talking, rapid talking.
断水	だんすい	water outage.
断定	だんてい	conclusion, decision.
昼寝	ひるね	nap (afternoon), siesta.
鉄砲	てっぽう	gun., wooden pole that wrestlers strike in practice., fugu.
分量	ぶんりょう	amount, quantity.
油断	ゆだん	negligence, carelessness, inattention, unpreparedness.
艶	つや	gloss, glaze., charm, romance, love, youthfulness., color, colour, feeling.
休息	きゅうそく	rest, relief, relaxation.
空想	くうそう	daydream, fantasy, fancy, vision.
兼ねる	かねる	to be unable to, to find difficult (unpleasant, awkward, painful) to do., to serve two or more functions or roles simultaneously, to contain (or combine) two or more features., to work in two or more jobs simultaneously (positions, etc.), to do alongside., to hesitate to do something (out of consideration for others)., to think of the future (as well as the present).
言葉遣い	ことばづかい	speech, expression, wording, language.
枯れる	かれる	to wither (of a plant), to be blasted, to die., to mature (of one's personality, abilities, etc.).
取り消す	とりけす	to cancel, to withdraw, to retract, to take back (words, etc.), to revoke.
診る	みる	to examine (medically).
爪	つめ	nail (e.g. fingernail, toenail), claw, talon, hoof., plectrum, pick., hook, clasp.
日陰	ひかげ	shade, shadow., sunshine.
暴れる	あばれる	to act violently, to rage, to struggle, to be riotous.
盆地	ぼんち	basin (e.g. between mountains).
枕	まくら	pillow, bolster., introduction (e.g. to a rakugo story), lead-in.
預かる	あずかる	to look after, to take care of, to keep, to hold on to, to keep in custody., to take charge of, to be entrusted with, to receive on deposit., to reserve (judgment), to leave undecided.
日日	ひにち	the number of days, date.
煙突	えんとつ	chimney, smokestack, funnel (of a ship), stovepipe., carrying a passenger without turning on the taximeter.
何しろ	なにしろ	at any rate, anyhow, anyway, in any case, because.
懐かしい	なつかしい	dear, desired, missed.
外れる	はずれる	to be disconnected, to get out of place, to be off, to be out (e.g. of gear).
起床	きしょう	rising, getting out of bed.
飢える	うえる, かつえる	to starve, to thirst, to be hungry.
呼び出す	よびだす	to summon, to call (e.g. phone), to convene, to decoy, to lure., to invoke (e.g. subroutine), to call, to open (e.g. a file).
刺さる	ささる	to stick into (something with a sharp point), to prick, to pierce, to get stuck (in), to lodge (in).
蛇口	じゃぐち	faucet, tap.
終点	しゅうてん	terminus, last stop (e.g. train).
初級	しょきゅう	elementary level.
仲良し	なかよし	intimate friend, close friend, bosom buddy, chum.
灯台	とうだい	lighthouse., old-fashioned interior light fixture comprising a wooden pole with an oil-filled dish and a wick atop it.
薄暗い	うすぐらい	dim, gloomy.
物置	ものおき	storage room, storeroom, lumber room.
明け方	あけがた	dawn.
夕日	ゆうひ, せきじつ, せきよう	evening sun, setting sun.
裏口	うらぐち	backdoor, rear entrance.
冷やす	ひやす	to cool (from room temperature), to chill, to refrigerate., to calm down, to cool off, to regain one's composure, to relax., to be frightened (at), to be scared (of).
消耗	しょうもう, しょうこう	exhaustion, consumption, waste, dissipation.
寝台	しんだい, ねだい	bed, couch.
挟む	はさむ	to interpose, to hold between, to insert., to be on either side (e.g. road), to be across (e.g. street, river), to be beyond.
歯磨き	はみがき	dental brushing, brushing one's teeth., dentifrice, toothpaste, tooth powder.
稀	まれ	rare, seldom.
打ち合わせ	うちあわせ	business meeting, previous arrangement, appointment, preparatory meeting., overlap (of a coat, etc.).
近づける	ちかづける	to bring near, to put close, to let come near, to associate with.
寝巻き	ねまき	sleep-wear, nightclothes, pyjamas, pajamas, nightgown, nightdress.
捕らえる	とらえる	to seize, to capture, to arrest., to grasp, to perceive, to treat (as).
生け花	いけばな, せいか	flower arrangement., fresh flowers.
着替える	きがえる, きかえる	to change one's clothes.
殖やす	ふやす	to increase, to add to, to augment.
名字	みょうじ	surname, family name.
編み物	あみもの	knitting, knitted material, crochet.
混ぜる	まぜる	to mix, to stir, to blend.
打ち消す	うちけす	to deny, to contradict., to negate (esp. a sound), to drown out.
時間割	じかんわり	timetable (esp. a weekly school timetable), schedule.
鈍い	にぶい, のろい	dull (e.g. a knife), blunt., thickheaded, obtuse, stupid., dull (sound, color, etc.), dim (light)., slow, sluggish, inert, lethargic., indulgent (esp. to the opposite sex), doting.
替わる	かわる	to succeed, to relieve, to replace., to take the place of, to substitute for, to take over for, to represent., to be exchanged, to change (places with), to switch.
坊ちゃん	ぼっちゃん	son (of others)., young master., green young man from a well-to-do family.
元々	もともと	originally, by nature, from the start.
引っ掛かる	ひっかかる	to be caught in, to be stuck in., to stop by, to drop in for a short visit, to be delayed, to take time., to get mixed up in (trouble), to get entangled in (a problem), to be involved with., to fall for (a trick), to be deceived, to be cheated., to be on one's mind, to worry one, to be bothered by, to feel uneasy., to be obstructed, to be hindered., to splash.
偏る	かたよる	to be one-sided, to incline, to be partial, to be prejudiced, to lean, to be biased, to be biassed.
交じる	まじる	to be mixed, to be blended with, to associate with, to mingle with, to interest, to join.
静まる	しずまる	to quieten down, to calm down, to subside, to die down, to abate, to be suppressed.
その他	そのほか, そのた	etc., otherwise, besides, in addition, the rest, the others, and so forth.
いつの間にか	いつのまにか	before one knows, before one becomes aware of, unnoticed, unawares.
ご無沙汰	ごぶさた	not writing or contacting for a while, neglecting (failing) to write (call, visit, etc.), long silence.
先ほど	さきほど	some time ago, not long ago, just now.
面倒くさい	めんどうくさい, めんどくさい	bother(some) to do, tiresome.
組み合わせ	くみあわせ	combination.
絨毯	じゅうたん	carpet, rug, runner.
ため息	ためいき	sigh.
問い合わせ	といあわせ	enquiry, inquiry, ENQ, query, interrogation.
追いかける	おいかける	to chase, to run after, to pursue.
関西	かんさい, かんせい	Kansai (south-western half of Japan, including Osaka).
腰掛け	こしかけ	seat, bench.
年生	ねんせい	pupil in ... year, student in ... year.
会館	かいかん	meeting hall, assembly hall.
研修	けんしゅう	training (esp. in-service), induction course.
深夜	しんや	late at night.
引き受ける	ひきうける	to be responsible for., to take over, to take up., to guarantee, to undertake., to contract (a disease).
一斉	いっせい	simultaneous, all at once.
共産	きょうさん	communism., Communist Party.
警備	けいび	defense, defence, guard, policing, security.
実	じつ, じち	truth, reality., sincerity, honesty, fidelity., content, substance., (good) result.
農薬	のうやく	agricultural chemical (i.e. pesticide, herbicide, fungicide, etc.), agrochemical, agrichemical.
未満	みまん	less than, insufficient.
着	ちゃく	counter for suits of clothing., arriving at ....
懸命	けんめい	eagerness, earnestness, risking one's life.
国王	こくおう	king.
作成	さくせい	drawing up (e.g. legal document, contract, will, etc.), preparing, writing, framing, making, producing, creating, creation.
有難い	ありがたい	grateful, thankful, welcome, appreciated, evoking gratitude.
交ざる	まざる	to be mixed, to be blended with, to associate with, to mingle with, to join.
見かけ	みかけ	outward appearance.
地盤	じばん, ちばん	ground, crust (earth), bed (gravel, river, etc.)., foundation (building, etc.), base., constituency, power base, support (electoral), footing, foothold.
農産物	のうさんぶつ	agricultural produce.
瓶詰め	びんづめ	bottling, bottled.
売れ行き	うれゆき	sales, demand.
引き返す	ひきかえす	to repeat, to send back, to bring back, to retrace one's steps.
学術	がくじゅつ	science, learning, scholarship.
青少年	せいしょうねん	youth, young person.
南米	なんべい	South America.
濃度	のうど	concentration, thickness, density., cardinality.
返る	かえる	to return, to come back, to go back., to turn over., (after the -masu stem of a verb) (to become) extremely, (to become) completely.
為す	なす	to build up, to establish., to form, to become (a state)., to accomplish, to achieve, to succeed in., to change into., to do, to perform.
拡充	かくじゅう	expansion.
長短	ちょうたん	length., long and short, advantages and disadvantages, pluses and minuses, strong and weak points, merits and demerits.
発射	はっしゃ	firing, shooting, discharge, catapult, ejaculation (sl).
溶岩	ようがん	lava.
功績	こうせき	achievements, merit, meritorious service, meritorious deed.
商	しょう	quotient., dealing, dealer, store., second degree (of the Japanese & Chinese pentatonic scale)., Shang (dynasty of China).
問	もん	counter for questions.
脅かす	おどかす	to threaten, to menace., to startle, to surprise.
学級	がっきゅう	(school) class.
初旬	しょじゅん	first 10 days of the month.
蒸気	じょうき	steam, vapour, vapor., steamship, steamboat, steamer.
長	ちょう	head, chief, leader, elder., merit, strong point., superiority., major (music).
内線	ないせん	phone extension, indoor wiring, inner line.
弁	べん	speech, tongue, talk, eloquence., dialect, brogue, accent., bento, Japanese box lunch., petal., valve., Oversight Department, division of the daijokan under the ritsuryo system responsible for controlling central and provincial governmental offices.
流域	りゅういき	(river) basin.
炭鉱	たんこう	coal mine, coal pit.
混合	こんごう	mixing, mixture, meld., miscegenation.
貯蔵	ちょぞう	storage, preservation.
童謡	どうよう	children's song, nursery rhyme.
防犯	ぼうはん	prevention of crime.
出	で	coming out, going out, outflow, efflux, rising (of the sun or moon)., attending (work), appearing (on stage), one's turn to go on., start, beginning., origins, background, person (or item) originating from ..., graduate of ..., native of ..., member of ... (lineage)., architectural member that projects outward., highest point of the stern of a ship., amount (comprising something), amount of time or effort required to do something.
短編	たんぺん	short (e.g. story, film).
整う	ととのう	to be prepared, to be in order, to be put in order, to be arranged.
開通	かいつう	opening, open, taking effect, becoming active.
大木	たいぼく	large tree.
伝記	でんき	biography, life story.
輸血	ゆけつ	blood transfusion.
地下水	ちかすい	underground water.
遠足	えんそく	excursion, outing, trip.
温帯	おんたい	temperate zone.
歌謡	かよう	song, ballad.
改めて	あらためて	another time, again, over again, once again, anew., formally, especially, intentionally, deliberately.
海水浴	かいすいよく	swimming in the ocean, sea bathing, seawater bath, going for a dip in the ocean.
恐縮	きょうしゅく	feeling obliged, being grateful, being thankful, being sorry, being ashamed.
月日	つきひ	time, years, days.
好き嫌い	すききらい	likes and dislikes, pickiness (about food), choosiness, fussiness, tastes, preferences.
至急	しきゅう	urgent, pressing.
巡る	めぐる	to go around., to return., to surround., to concern (usu. of disputes).
焦げる	こげる	to burn, to be burned.
障子	しょうじ	shoji (paper sliding door).
人通り	ひとどおり	pedestrian traffic.
人命	じんめい	(human) life.
扇風機	せんぷうき	electric fan.
送料	そうりょう	postage, carriage.
足る	たる	to be sufficient, to be enough, to be worthy of.
着替え	きがえ	changing clothes, change of clothes.
抽象	ちゅうしょう	abstract.
長方形	ちょうほうけい	rectangle, oblong.
便所	べんじょ	toilet, lavatory, rest room, latrine, comfort station.
方程式	ほうていしき	equation, formula., method for solving a problem, set way of achieving a particular result.
迷う	まよう	to lose one's way., to waver, to hesitate, to be of two minds over, to be puzzled, to be perplexed., to give into temptation, to lose control of oneself., to turn in one's grave.
溶かす	とかす	to melt, to dissolve.
末っ子	すえっこ	youngest child.
蛍光灯	けいこうとう	fluorescent lamp, fluorescent light., person who is slow to react, someone slow on the uptake.
日当たり	ひあたり	exposure to the sun, sunny place., per day.
転々	てんてん	moving from place to place, being passed around repeatedly., rolling about.
集	しゅう	collection, compilation.
衣食住	いしょくじゅう	necessities of life (food, clothing & shelter).
回数券	かいすうけん	book of tickets.
五十音	ごじゅうおん	the Japanese syllabary.
四角い	しかくい	square, rectangular.
写生	しゃせい	sketching, drawing from nature, portrayal, description.
醜い	みにくい	ugly, unattractive., unsightly, unseemly.
出迎える	でむかえる	to meet, to greet.
針金	はりがね	wire.
図表	ずひょう	chart, diagram, graph, figure.
扇子	せんす	folding fan.
淡水	たんすい	fresh water (i.e. not salt water).
鉄橋	てっきょう	railway bridge, iron bridge.
熱する	ねっする	to heat, to heat up.
捕る	とる	to take, to catch, to capture.
毛糸	けいと	knitting wool.
包帯	ほうたい	bandage, dressing.
悠々	ゆうゆう	quiet, calm, leisurely, easy.
応ずる	おうずる	to answer, to respond, to meet., to satisfy, to accept.
加熱	かねつ	heating, application of heat.
勘違い	かんちがい	misunderstanding, wrong guess.
気体	きたい	vapour, vapor, gas.
空っぽ	からっぽ	empty, vacant, hollow.
掘る	ほる	to dig, to excavate, to hollow., to delve into., to dig up (e.g. vegetables)., (for two men) to have anal sex.
敬語	けいご	honorific, term of respect, polite expression, honorific language.
個体	こたい	individual, specimen.
交通機関	こうつうきかん	transportation facilities.
座布団	ざぶとん	zabuton (flat floor cushion used when sitting or kneeling; usu. rectangular).
災難	さいなん	calamity, misfortune, disaster.
散る	ちる	to fall (e.g. blossoms, leaves)., to scatter, to be dispersed., to disappear, to dissolve, to break up., to spread, to run, to blur., to die a noble death.
集金	しゅうきん	money collection.
図鑑	ずかん	illustrated reference book, illustrated encyclopedia (esp. for children), picture book.
炊事	すいじ	cooking, culinary arts.
損得	そんとく	loss and gain, advantage and disadvantage.
体積	たいせき	capacity, volume.
短所	たんしょ	defect, demerit, weak point, disadvantage.
中性	ちゅうせい	neutrality (incl. chemical, electrical, etc.), indifference., sexlessness, androgyny, androgyne, neuter., neuter gender.
吐き気	はきけ	nausea, sickness in the stomach.
特売	とくばい	special sale.
噴水	ふんすい	water fountain.
方角	ほうがく	direction, way, compass point.
味わう	あじわう	to taste, to savor, to relish.
羊毛	ようもう	wool.
論ずる	ろんずる	to argue, to discuss, to debate.
悔しい	くやしい, くちおしい	vexing, annoying, frustrating, regrettable, mortifying.
感ずる	かんずる	to feel, to sense.
映る	うつる	to be reflected, to harmonize with (harmonise), to come out (photo), to be projected, to be displayed (on a screen).
幾分	いくぶん	somewhat, to some extent, to some degree., some, part, portion.
櫛	くし	comb.
形容詞	けいようし	(true) adjective, i-adjective.
稽古	けいこ	practice, practising, training, study.
原産	げんさん	place of origin, habitat.
工員	こういん	factory worker.
慌ただしい	あわただしい	busy, hurried, confused, flurried.
作製	さくせい	manufacture.
手ごろ	てごろ	moderate, handy, convenient, reasonable.
手洗い	てあらい	washing one's hands, water (or basin, etc.) for washing one's hands., restroom, lavatory, toilet., hand-washing (laundry, etc.).
占う	うらなう	to tell someone's fortune, to forecast, to predict, to divine.
洗面	せんめん	wash up (one's face), have a wash.
送別	そうべつ	farewell, send-off.
濁る	にごる	to become muddy, to become cloudy, to get impure (of a liquid, gas, etc.)., to become dull (of a sound, color, etc.), to become hoarse., to become impure (of a heart, society, etc.), to be corrupted, to be polluted., to become voiced, to add voiced consonant marks.
転がす	ころがす	to roll., to turn over, to tip over, to throw down., to leave., to buy and sell (quickly for a profit).
転がる	ころがる	to roll, to tumble., to fall over, to roll over., to lie down., to be scattered about, to be common., (of a situation or outcome) to change, to turn out.
怒鳴る	どなる	to shout, to yell.
彼方	かなた, あなた	beyond, across, the other side, the distance.
複写	ふくしゃ	copy, duplicate.
膨らます	ふくらます	to swell, to expand, to inflate, to bulge.
無地	むじ	plain, unfigured.
例える	たとえる	to compare, to liken, to speak figuratively, to illustrate, to use a simile.
真っ青	まっさお	deep blue, bright blue., ghastly pale, pallid, white as a sheet.
麓	ふもと	foot (of a mountain or hill), bottom, base.
仮定	かてい	assumption, supposition, hypothesis.
熟語	じゅくご	kanji compound., idiom, idiomatic phrase.
蒸発	じょうはつ	evaporation., disappearance (of people intentionally concealing their whereabouts), unexplained disappearance.
食塩	しょくえん	table salt.
心当たり	こころあたり	having some knowledge of, happening to know.
真空	しんくう	vacuum, hollow, empty.
人文科学	じんぶんかがく	humanities, social sciences, liberal arts.
存じる	ぞんじる	to think, feel, consider, know, etc..
怠る	おこたる	to be negligent in doing something, to shirk, to be off one's guard.
大ざっぱ	おおざっぱ	rough (as in not precise), broad, sketchy.
物騒	ぶっそう	dangerous, disturbed, insecure.
平凡	へいぼん	common, commonplace, ordinary, mediocre.
編	へん	compilation (of a text), editing., volume (of a text)., completed literary work.
縫う	ぬう	to sew, to stitch., to weave one's way (e.g. through a crowd).
目印	めじるし	mark, sign, landmark.
領事	りょうじ	consul.
冷める	さめる	to become cool (e.g. from a high temperature to room temperature), to come down (fever)., to cool down (interest), to abate, to subside, to dampen.
ご苦労さま	ごくろうさま	thank you very much for your ..., I appreciate your efforts.
緯度	いど	latitude (nav.).
下駄	げた	geta, Japanese wooden clogs., turn (in set-type proofing), upside-down character.
蓋	ふた, がい, フタ	cover, lid, cap.
信ずる	しんずる	to believe, to believe in, to place trust in, to confide in, to have faith in.
水滴	すいてき	drop of water., vessel for replenishing inkstone water.
正方形	せいほうけい	square.
不潔	ふけつ	unclean, dirty, filthy, impure.
浮かぶ	うかぶ	to float, to be suspended., to rise to surface., to come to mind, to have inspiration.
平気	へいき	coolness, calmness, composure, unconcern., all right, OK, okay.
目次	もくじ	table of contents.
険しい	けわしい	precipitous, rugged, inaccessible, impregnable, steep., grim, severe, stern.
交差	こうさ	crossing, intersection., (genetic) crossing over.
広める	ひろめる	to spread, to propagate, to popularize, to disseminate., to broaden, to extend, to widen, to enlarge.
四角	しかく	square.
酒場	さかば	bar, bar-room.
縮む	ちぢむ, ちじむ	to shrink, to contract, to diminish (in size).
照らす	てらす	to shine on, to illuminate., to compare (with), to refer to.
照る	てる	to shine., to look slightly upward (of a noh mask; indicating joy, etc.).
水平線	すいへいせん	horizon (related to sea or lakes).
通	つう	connoisseur, authority., counter for letters, notes, documents, etc..
突っ込む	つっこむ	to thrust (something) into (something), to cram., to plunge into, to go into deeply., to get involved with, to meddle, to poke one's nose into., to riposte, to retort, to quip.
崩す	くずす	to destroy, to demolish, to pull down, to tear down, to level., to disturb, to put into disorder, to throw off balance, to make shaky., to relax (one's pose), to make oneself at ease., to break (a bill), to change, to make change., to write in cursive style, to write in running style., to break into a smile, to let off a smile., to lower (a price).
牧畜	ぼくちく	stock-farming.
和英	わえい	Japanese-English.
飢饉	ききん	famine, drought, shortage, crop failure.
若々しい	わかわかしい	youthful, young.
栓	せん	stopper, cork, stopcock.
縞	しま	stripe, bar, streak.
省略	しょうりゃく	omission, abbreviation, abridgment, abridgement.
通用	つうよう	popular use, circulation., to pass as.
同	どう	the same, the said, ibid..
独り言	ひとりごと	soliloquy, monologue, speaking to oneself.
訳す	やくす	to translate, to interpret.
幼稚	ようち	infancy, childish, infantile.
領収	りょうしゅう	receipt, voucher.
近々	ちかぢか, きんきん	soon, nearness, before long.
所々	ところどころ, しょしょ	here and there, some parts (of something), several places.
長引く	ながびく	to be prolonged, to drag on.
下品	げひん	vulgarity, meanness, indecency, coarseness.
偶数	ぐうすう	even number.
糊	のり	paste, glue, clothing starch.
耕す	たがやす	to till, to plow, to plough, to cultivate.
催促	さいそく	pressing, demanding, urging, demand, request, claim.
貸家	かしや, かしいえ	house for rent.
湯気	ゆげ	steam, vapour, vapor.
等分	とうぶん	division into equal parts.
逃がす	にがす	to miss, to lose, to give away, to let go, to set free, to let get away.
日本式	にほんしき	Japanese style.
肌着	はだぎ, はだぎぬ	underwear, underclothes, lingerie, chemise, singlet.
毎度	まいど	each time., thank you for your continued patronage.
目上	めうえ	superior, superiors, senior.
火傷	やけど, かしょう	burn, scald.
中指	なかゆび, ちゅうし	middle finger, long finger, second finger, tall finger, middle toe, third toe.
怪しい	あやしい	suspicious, dubious, doubtful, dodgy, suspicious (referring to a potential amorous relation), dangerous (e.g. financial situation), ominous (e.g. weather), strange, shady, fishy., charming, bewitching, mysterious.
裁縫	さいほう	sewing.
実る	みのる	to bear fruit, to ripen.
純情	じゅんじょう	pure heart, naivete, self-sacrificing devotion.
誓う	ちかう	to swear, to vow, to take an oath, to pledge.
脱線	だっせん	derailment., digression, deviation.
着せる	きせる	to put clothes on (someone)., to plate, to gild, to veneer., to accuse (of some crime), to give (a bad name).
直角	ちょっかく	right angle, perpendicular.
泊める	とめる	to give shelter to, to lodge, to put up, to accommodate.
薄める	うすめる	to dilute, to water down.
命ずる	めいずる	to command, to appoint.
話し掛ける	はなしかける	to address (someone), to accost a person, to talk (to someone)., to begin to talk, to start a conversation.
椀	わん	bowl (wooden).
手拭い	てぬぐい	(hand) towel.
雨戸	あまど	sliding storm shutter.
回り道	まわりみち	detour, diversion.
曲げる	まげる	to bend, to crook, to bow, to curve, to curl., to lean, to tilt, to incline, to slant., to bend (the truth), to distort, to twist, to pervert., to yield (a point), to depart (from a principle), to ignore (what one really thinks)., to pawn.
腰掛ける	こしかける	to sit (down).
三日月	みかづき, みかずき	new moon, crescent moon.
惨め	みじめ	miserable, wretched, unhappy, sad, pitiable.
失恋	しつれん	disappointed love, broken heart, unrequited love, being lovelorn.
承る	うけたまわる	to hear, to be told, to know., to receive (order), to undertake, to comply, to take (a reservation, etc.).
人造	じんぞう	man-made, synthetic, artificial.
船便	ふなびん	surface mail (ship), sea mail., ferry service, steamer service.
彫る	ほる, える	to carve, to engrave, to sculpt, to chisel., to tattoo.
伝染	でんせん	contagion, infection.
符号	ふごう	sign, mark, symbol, code., sign (e.g. positive, negative).
曖昧	あいまい	vague, ambiguous, unclear., fuzzy.
燃やす	もやす, もす	to burn.
差し支え	さしつかえ	hindrance, impediment.
お参り	おまいり	worship, shrine visit.
アイデア		idea.
メーター		meter (i.e. measuring device)., metre (i.e. 100 cm), meter.
偉い	えらい	great, excellent, admirable, remarkable, distinguished, important, celebrated, famous, eminent., awful, terrible.
卸す	おろす	to sell wholesale., to grate (e.g. vegetables)., to cut up fish.
裂く	さく	to tear, to rip up., to cut up, to cleave, to cut open (esp. the abdomen)., to forcibly separate (i.e. two lovers)., to spare (time, money, etc.), to use part of something.
見上げる	みあげる	to look up at, to raise one's eyes., to look up to, to admire, to respect.
胡椒	こしょう, コショウ	pepper.
御免	ごめん	your pardon, declining (something), dismissal, permission.
荒い	あらい	rough, rude, wild.
取り出す	とりだす	to take out, to produce, to pick out., to fetch, to retrieve.
助かる	たすかる	to be saved, to be rescued, to survive., to escape harm, to be spared damage., to be helped, to be saved trouble.
酔っ払い	よっぱらい	drunkard.
早速	さっそく	at once, immediately, without delay, promptly.
退ける	のける, どける	to put something out of the way, to move (something, someone) aside., to remove, to exclude, to take away., to set aside, to keep apart., to remove (someone) from the group, to shun., (after the -te form of a verb) to do well despite difficulties, to accomplish despite adversity., (after the -te form of a verb) to do resolutely, to do boldly.
著す	あらわす	to write, to publish.
凋む	しぼむ	to wither (e.g. flowers, dreams), to sag (e.g. balloon, grapes), to fade (away), to shrivel, to wilt, to deflate.
定規	じょうぎ	(measuring) ruler.
釘	くぎ	nail (i.e. small metal spike).
裏返す	うらがえす	to turn inside out, to turn the other way, to turn (something) over.
恋しい	こいしい	yearned for, longed for, missed.
温める	あたためる, あっためる, ぬくめる	to warm, to heat.
落ち着く	おちつく	to calm down, to compose oneself, to regain presence of mind., to calm down, to settle down, to die down, to become stable, to abate., to settle down (in a location, job, etc.), to settle in., to be settled, to be fixed, to have been reached., to harmonize with, to harmonise with, to match, to suit, to fit., to be unobtrusive, to be quiet, to be subdued.
係わる	かかわる	to be affected, to be influenced., to be concerned with, to have to do with., to stick to (opinions).
書き取り	かきとり	writing down from other written material, writing kanji text from hiragana., transcription (of spoken material).
蓄える	たくわえる	to store, to lay in stock., to have a beard, to grow a beard.
匂う	におう	to be fragrant, to smell (good)., to stink, to smell (bad)., to glow, to be bright., to smack of, to show hints of.
乗り越し	のりこし	riding past (one's station).
引き算	ひきざん	subtraction.
引き止める	ひきとめる	to detain, to check, to restrain.
行ってきます	いってきます	I'm off, see you later.
ご遠慮ください	ごえんりょください	please refrain from ~ (e.g. smoking, etc.).
意地悪	いじわる	malicious, ill-tempered, unkind.
引力	いんりょく	attraction (e.g. magnetic, gravitation), affinity, gravitational pull., attractiveness, magnetism.
襖	ふすま	fusuma (Japanese sliding screen).
下書き	したがき	rough copy, draft, draught.
行き成り	いきなり, ゆきなり	abruptly, suddenly, all of a sudden, without warning.
自習	じしゅう	self-study.
蒸し暑い	むしあつい	humid, sultry.
水筒	すいとう	canteen, flask, water bottle, thermos.
速達	そくたつ	express, special delivery.
透き通る	すきとおる	to be(come) transparent.
背負う	せおう, しょう	to be burdened with, to take responsibility for, to carry on back or shoulder., to have (something) in the background, to be in front (of something).
迷信	めいしん	superstition, superstitious belief.
鳴らす	ならす	to ring, to sound, to chime, to beat, to snort (nose)., to be popular, to be esteemed, to be reputed., to state, to insist, to complain.
或	ある	a certain ..., some ....
映す	うつす	to project, to reflect, to cast (shadow).
採る	とる	to adopt (measure, proposal)., to pick (e.g. fruit), to catch (e.g. insects), to take (e.g. a sample)., to assume (attitude)., to take on (i.e. hire), to engage.
申し訳ない	もうしわけない	I'm sorry, (it's) inexcusable, I feel regretful, I feel guilty., thank you very much (for help, etc.).
緩い	ゆるい	loose., lenient, lax., gentle (curve, slope, etc.)., slow, weak., soft, not firm.
近寄る	ちかよる	to approach, to draw near.
比較的	ひかくてき	comparative, relative.
名詞	めいし, なことば	noun.
目覚まし	めざまし	alarm clock., opening one's eyes, keeping one's eyes open., type of candy given to a child after it wakes up from a nap.
目立つ	めだつ	to be conspicuous, to stand out.
薬指	くすりゆび	ring finger, fourth finger.
立ち止まる	たちどまる	to stop, to halt, to stand still.
騒々しい	そうぞうしい	noisy, boisterous.
倣う	ならう	to imitate, to follow, to emulate.
お辞儀	おじぎ	bow, bowing.
一通り	ひととおり	from start to end, in general., ordinary, usual., briefly, roughly., one method.
概論	がいろん	introduction, outline, general remarks.
戸棚	とだな	cupboard, locker, closet, wardrobe, cabinet.
澄む	すむ	to clear (e.g. weather), to become transparent.
惜しい	おしい	regrettable, disappointing., precious, dear, valuable., too good for, deserving better., almost but not quite.
担ぐ	かつぐ	to shoulder, to carry on one's shoulder., to take (someone) for a ride, to deceive, to take in.
探る	さぐる	to feel around for, to fumble for, to grope for, to search for, to look for., to investigate, to probe into, to spy on, to sound out., to explore (parts unknown), to enjoy (natural beauty).
丁目	ちょうめ	district of a town, city block (of irregular size).
定休日	ていきゅうび	regular holiday, fixed day off, regular closing day.
突き当たる	つきあたる	to run into, to collide with, to come to the end of (a street).
妨げる	さまたげる	to disturb, to prevent, to obstruct, to hinder.
姪	めい	niece.
矢印	やじるし	arrow (mark or symbol), directional marker or indicator.
落第	らくだい	failure, dropping out of a class.
飛び込む	とびこむ	to jump in, to leap in, to plunge into, to dive.
汚す	よごす, けがす	to pollute, to contaminate, to soil, to make dirty, to stain., to disgrace, to dishonour, to dishonor, to defile.
何分	なにぶん	some, any, (a) little, of some kind, of some sort., please., anyway, anyhow, at any rate, after all.
休講	きゅうこう	lecture cancellation, cancelling (lecture, class, etc.).
鋸	のこぎり	saw., musical saw.
固まる	かたまる	to harden, to solidify., to become firm, to become certain., to gather (together), to assemble, to huddle together.
受け持つ	うけもつ	to take (be in) charge of.
青白い	あおじろい	pale, pallid., bluish-white.
妥当	だとう	valid, proper, right, appropriate.
張り切る	はりきる	to be in high spirits, to be full of vigor (vigour), to be enthusiastic, to be eager, to stretch to breaking point.
跳ねる	はねる	to jump, to leap, to prance, to spring up, to bound, to hop., to break up, to close, to come to an end., to hit (e.g. to have a car hit something or someone).
目指す	めざす	to aim at, to have an eye on., to go toward, to head for.
夕立	ゆうだち	(sudden) evening shower (rain).
落とし物	おとしもの	lost property.
乾かす	かわかす	to dry (clothes, etc.), to desiccate.
仕方がない	しかたがない	it can't be helped, it's inevitable, it's no use, can't stand it, being impatient, being annoyed.
出来上がる	できあがる	to be completed, to be finished, to be ready (e.g. to serve or eat)., to be very drunk.
草履	ぞうり, じょうり	zori, Japanese sandals.
番地	ばんち	house number, address.
払い込む	はらいこむ	to deposit, to pay in.
編む	あむ	to knit, to plait, to braid., to compile (anthology, dictionary, etc.), to edit.
茂る	しげる	to grow thickly, to be in full leaf, to be rampant, to luxuriate, to be luxurious.
欲張り	よくばり	avarice, covetousness, greed.
入れ物	いれもの	container, case, receptacle., (euph. for) coffin, casket.
思い付く	おもいつく	to think of, to hit upon, to come into one's mind, to be struck with an idea.
教わる	おそわる	to be taught.
見下ろす	みおろす	to overlook, to command a view of, to look down on., to despise, to look down on.
待ち合わせる	まちあわせる	to rendezvous, to meet at a prearranged place and time, to arrange to meet.
追い越す	おいこす	to pass (e.g. car), to overtake., to surpass, to outstrip, to get ahead of, to outdistance.
拝む	おがむ	to assume the posture of praying, to press the palms and fingers of both hands together, to do reverence (e.g. before a statue of the Buddha), to pay one's respects., to beg, to make a supplication., to see (something or someone of high status).
嫌がる	いやがる	to hate, to dislike.
隙	すき, げき, ひま, すきけ	gap, space., break, interlude, interval., chink (in one's armor, armour), chance, opportunity., breach (of a relationship between people).
祭る	まつる	to deify, to enshrine., to pray, to worship.
始終	しじゅう	continuously, from beginning to end, from first to last.
清い	きよい	clear, pure, noble.
組み立てる	くみたてる	to assemble, to set up, to construct.
憎む	にくむ	to hate, to detest.
補う	おぎなう	to compensate for, to supplement.
頼もしい	たのもしい	reliable, trustworthy, hopeful, promising.
洒落	しゃれ, シャレ	joke, pun, witticism., smartly dressed, stylish, fashion-conscious, refined.
小便	しょうべん, しょんべん	urine, piss, pee., breaking a contract.
匙	さじ, しゃじ, かい	spoon.
着々	ちゃくちゃく	steadily.
道順	みちじゅん	itinerary, route.
引っ込む	ひっこむ	to draw back, to sink, to cave in., to be set back (e.g. from a road)., to withdraw (e.g. from the public eye), to retire to (somewhere), to stay indoors, to butt out, to stay out of it.
甘やかす	あまやかす	to pamper, to spoil.
句読点	くとうてん	punctuation mark, punctuation marks.
桁	けた	column, beam, girder, crossbeam, spar, yard., digit, decade, order of magnitude.
片付く	かたづく	to be put in order, to be put to rights., to be disposed of, to be solved., to be finished., to be married (off).
瞼	まぶた, まなぶた	eyelid, eyelids.
凸凹	でこぼこ, とつおう, だくぼく	unevenness, roughness, ruggedness., inequality.
振る舞う	ふるまう	to behave, to conduct oneself., to entertain, to treat someone (to a drink), to make tea for someone (tea ceremony).
甦る	よみがえる	to be resurrected, to be resuscitated, to be rehabilitated, to be revived, to be refreshed, to be restored., to be recalled (e.g. memories), to be brought back.
威張る	いばる, えばる	to put on airs, to act big, to throw one's weight about, to be overbearing, to be domineering, to be bossy, to be pushy, to be proud, to be haughty, to be arrogant, to swagger, to boast, to brag.
帰す	かえす	to send (someone) back, to send (someone) home.
隙間	すきま	crevice, crack, gap, opening.
四捨五入	ししゃごにゅう	rounding half up (i.e. fractions).
重なる	かさなる	to be piled up, to lie on top of one another., to come one after another, to happen over and over, to pile up (e.g. stress), to accumulate., to overlap (each other), to occur at the same time, to happen simultaneously.
甚だしい	はなはだしい	extreme, excessive, terrible, intense, severe, serious, tremendous, heavy (damage).
生意気	なまいき	impertinent, saucy, cheeky, conceit, audacious, brazen.
箪笥	たんす, タンス	chest of drawers, bureau, cabinet, tansu, dresser.
勇ましい	いさましい	brave, valiant, gallant, courageous., stirring, vigorous, rousing.
区切る	くぎる	to demarcate, to delimit, to divide (an area), to mark off, to cut off., to punctuate, to put an end to (e.g. a sentence), to insert pauses or breaks (e.g. when reading aloud).
付き合う	つきあう	to associate with, to keep company with, to go out with, to go steady with, to get on with., to go along with, to follow someone's lead, to accompany someone, to compromise.
経度	けいど	longitude.
散らかる	ちらかる	to be in disorder, to lie scattered around.
酸っぱい	すっぱい	sour, acid.
治める	おさめる	to govern, to manage., to subdue.
湿る	しめる, しとる	to be wet, to become wet, to be damp, to be moist., to be in low spirits, to feel depressed.
上品	じょうひん	elegant, refined, polished.
粗筋	あらすじ	outline, summary.
卑怯	ひきょう	cowardice, meanness, unfairness.
便箋	びんせん	writing paper, stationery.
錆	さび	rust.
思いがけない	おもいがけない	unexpected, contrary to expectations, by chance, casual.
言い出す	いいだす	to start talking, to speak, to tell, to propose, to suggest, to break the ice.
更ける	ふける	to get late, to advance, to wear on.
恨む	うらむ	to resent, to curse, to feel bitter, to blame, to bear a grudge., to regret.
散らす	ちらす	to scatter, to cause a shower of., to disperse, to distribute, to spread., to resolve (a symptom, condition, etc.), to relieve, to get rid of, to cure., to distract, to divert., to do ... wildly (i.e. disorderly or frequently), to do ... all over the place.
思い込む	おもいこむ	to be under impression that, to be convinced that, to imagine that, to set one's heart on, to be bent on.
騒がしい	さわがしい	noisy, boisterous., turbulent (era, etc.), troubled.
払い戻す	はらいもどす	to repay, to pay back.
溶け込む	とけこむ	to melt into, to merge into., to fit in, to adapt, to blend.
皺	しわ	wrinkle, crease., ripple.
塩辛い	しおからい, からい	salty (taste), briny.
田んぼ	たんぼ, でんぽ	paddy field, farm.
捩る	ねじる, よじる, もじる	to screw, to twist., to distort, to parody, to make a pun., to torture, to wrest.
やむを得ない	やむをえない	cannot be helped, unavoidable.
お手伝いさん	おてつだいさん	maid.
御洒落	おしゃれ, オシャレ	smartly dressed, stylish, fashion-conscious., someone smartly dressed., to dress up, to be fashionable.
嚏	くしゃみ, くさめ, くっさめ, クシャミ	sneeze., spoken twice in response to someone sneezing as a charm against an early death.
草臥れる	くたびれる	to get tired, to be exhausted., to wear out, to be battered from long use.
くっ付く	くっつく	to adhere to, to stick to, to cling to., to keep close to, to go along with., to get involved with, to be thick with, to become intimate.
くっ付ける	くっつける	to attach, to stick together, to paste, to glue., to place together, to put side-by-side., to make someone get married, to get someone hitched.
吃逆	しゃっくり	hiccough, hiccup.
その上	そのうえ	in addition, furthermore., above (which), on top of (which).
ドキドキ		thump-thump, bang-bang, pit-a-pat, pitapat, pitter-patter., to beat fast (of one's heart), to throb, to pound, to palpitate.
打付ける	うちつける	to nail., to knock, to bang (e.g. one's head), to strike (hard)., to throw (e.g. a rock), to fling.
ぶら下げる	ぶらさげる	to hang, to suspend, to dangle, to swing, to carry.
若しかしたら	もしかしたら	perhaps, maybe, perchance, by some chance, by any chance.
若しかすると	もしかすると	perhaps, maybe, by some chance.
寄越す	よこす	to send, to forward., to hand over (e.g. money).
アクセント		accent (in language)., stress, highlight, accent.
アンテナ		antenna., person who collects information or opinions.
イメージ		(one's) image., (computer) image., mental image, impression, artist's impression.
インタビュー		interview (i.e. television, newspaper, etc.).
ウール		wool.
エチケット		etiquette.
オーケストラ		orchestra.
オートメーション		automation.
オルガン		organ (musical instrument).
カーブ		curve, turn., curve ball (baseball).
カセット		cassette (tape)., game cartridge.
カバー		cover (e.g. book), coverage., to compensate for (a loss), to offset (a weakness), to back up., kava (Piper methysticum), cava, kavakava., cava, Spanish sparkling wine.
カラー		collar., color, colour., hair colouring (coloring)., calla (variety of arum lily).
カロリー		calorie.
キャンパス		campus.
クーラー		cooler, air conditioner.
クリーニング		cleaning, dry cleaning, laundry service.
コース		course (route, trail, course of study, course of action, plan, option)., full course meal (multiple dishes served in sequence), prix fixe meal.
コック		cook, chef., tap, spigot, faucet, cock., cock (male fowl)., cock (penis).
コンクール		contest.
混凝土	コンクリート, こんくりいと	concrete.
コンセント		electrical outlet (concentric plug)., consent., concentric.
護謨	ゴム, ごむ	gum, rubber., eraser., condom.
サークル		group with a common interest (e.g. students), club (e.g. company sports club), circle., circle (shape).
サイレン		siren.
サラリーマン		office worker, company employee, company man.
シーズン		season (fruits and vegetables, sporting, holidays).
シーツ		sheet, bed sheet.
シャッター		camera shutter., shutter (door, window, etc.).
シリーズ		series.
ジャーナリスト		journalist.
スクール		school.
スケジュール		schedule.
スタート		start.
スチュワーデス		stewardess, (female) flight attendant.
ステージ		stage., performance.
ストップ		stop.
スピーカー		speaker.
スマート		smart, stylish., slim.
スライド		slide., change (in value or situation), proportional change., to slide, to slip., to change (in value, e.g. with a sliding scale), to change (in situation).
セメント		cement.
センチ		centimeter., centi-, 10^-2., sentimental.
ダイヤモンド		diamond.
ダイヤル		dial.
ダブル		double., double bed, hotel room with a double bed., double-breasted., double-cuffed., double width (of cloth; usu. 1.42 meters)., doubles (e.g. in tennis)., biracial person (esp. half-Japanese), person of mixed parentage.
ダム		dam., dumb.
チョーク		chalk., choke., chock.
テーマ		theme, topic, subject matter, motif, project, slogan.
テンポ		tempo.
トレーニング		training.
ナイロン		nylon.
ナンバー		number.
ニコニコ		with a friendly grin, smilingly.
ネックレス		necklace.
ハンドル		handle., steering wheel., (bicycle) handlebar.
バケツ		bucket, pail., skip.
バック		back., to go backwards, to reverse., to refund a customer.
発条	ばね, ぜんまい, はつじょう, だんき, バネ	spring (e.g. coil, leaf), mainspring, power spring.
バランス		balance.
パターン		pattern.
パンツ		underpants, pants, briefs, panties, shorts, knickers., trousers (esp. women's), jodhpurs, breeches, pants, trunks (e.g. swimming).
ビタミン		vitamin.
ビニール		vinyl.
ピストル		pistol.
ピンク		pink.
ファスナー		fastener, zipper.
フライパン		fry pan, frying pan.
ブラウス		blouse.
プラスチック		plastic.
プラットホーム		platform.
プリント		print, copy., handout, flyer.
プログラム		program, programme.
ヘリコプター		helicopter.
ベテラン		person with a lot of experience, old hand, veteran (in a particular field).
ボーナス		bonus.
ポスター		poster.
マイナス		minus.
マスク		mask.
マフラー		muffler (garment, vehicle), scarf.
マラソン		marathon, long-distance race.
マンション		large apartment (from mansion), apartment house.
ミシン		sewing machine.
ミリ		milli-, 10^-3., millimetre, millimeter.
メニュー		menu., schedule, program, programme., (computer) menu.
モーター		motor.
モダン		modern.
モデル		model.
ラッシュアワー		rush hour.
ランチ		lunch., launch., ranch.
ランニング		running., tank top.
リズム		rhythm.
リットル		litre.
リボン		ribbon.
レクリエーション		recreation., re-creation.
レジャー		leisure.
レベル		level, standard, amount, degree, gradation, grade, rank, class, floor, storey (story), layer, stratum., spirit level, (surveyor's) level., minor release sequence number (software versioning)., flat, level., rebel.
レンズ		lens.
ローマ字	ローマじ, ろーまじ	Latin alphabet, transliteration of Japanese in "Roman" or Latin letters, romanization, romanisation, romaji.
ロッカー		locker., rocker.
ロビー		lobby, lounge.
ワンピース		dress.
慰める	なぐさめる	to comfort, to console, to amuse.
一休み	ひとやすみ	(short) rest, breather, break.
一旦	いったん	once., for a moment, temporarily.
溢れる	あふれる	to overflow, to brim over, to flood.
引っ繰り返る	ひっくりかえる	to be overturned, to be upset, to topple over, to be reversed.
円周	えんしゅう	circumference.
煙い	けむい, けぶい	smoky.
凹む	へこむ	to be dented, to be indented, to yield to, to give, to sink, to collapse, to cave in., to be overwhelmed, to feel down, to be forced to yield, to be daunted, to be snubbed.
下らない	くだらない	good-for-nothing, stupid, trivial, worthless.
仮名遣い	かなづかい	kana orthography, syllabary spelling.
可愛がる	かわいがる	to love, to be affectionate, to favor, to favour, to be partial to., to torment, to tease, to be rough with.
家	け	house (e.g. of Tokugawa), family.
解く	ほどく	to unfasten, to untie, to unwrap (e.g. parcel).
各	かく	each, every, all.
各地	かくち	every place, various places.
括弧	かっこ	parentheses, brackets.
渇く	かわく	to be thirsty.
巻く	まく	to wind, to coil, to roll, to wear (e.g. turban, scarf)., to envelope, to shroud., to outflank, to skirt., to link (verse).
喧しい	やかましい, かしましい, かしがましい, かまびすしい	noisy, boisterous., strict, faultfinding, carping, fussy.
漢和	かんわ	China and Japan., Chinese and Japanese (languages)., Chinese Character-Japanese dictionary.
含める	ふくめる	to include (in a group or scope)., to instruct, to make one understand., to include (a nuance), to put in (an implication)., to put in (someone's) mouth., to permeate with flavor.
幾	いく	some, several., many., how many?, how much?.
却って	かえって	on the contrary, rather, all the more, instead.
客間	きゃくま	parlor, parlour, guest room.
汲む	くむ	to draw (water), to fetch (water), to ladle, to dip, to scoop, to pump., to have a drink together., to consider, to sympathize with, to sympathise with.
響く	ひびく	to resound, to be heard far away., to reverberate, to shake, to vibrate., to come (home), to remain (with someone)., to have an effect, to make an impression.
屑	くず, クズ	waste, scrap, garbage, dregs., chad.
敬う	うやまう	to show respect, to honour, to honor.
繋がり	つながり	connection, link, relationship.
繋がる	つながる	to be tied together, to be connected to, to be related to.
欠伸	あくび, けんしん	yawn, yawning (and stretching)., kanji "yawning" radical (radical 76).
見っともない	みっともない	shameful, disgraceful, indecent, unseemly, unbecoming, improper.
謙遜	けんそん	humble, humility, modesty, being humble.
跨ぐ	またぐ	to step over, to step across, to stride over, to stride across, to cross., to stretch over, to span, to bridge, to saddle, to straddle.
呉れ呉れも	くれぐれも	repeatedly, sincerely, earnestly.
ご馳走さま	ごちそうさま	word used after one has been treated (esp. used after a meal)., used after hearing something lovey-dovey.
御中	おんちゅう	and Company, Messrs, for the attention of ....
厚かましい	あつかましい	impudent, shameless, brazen.
向け	むけ	intended for ..., oriented towards ..., aimed at ....
忽ち	たちまち	at once, in a moment, suddenly, all at once, quickly, promptly, immediately.
再	さい	re-, again, repeated, deutero-, deuto-, deuter-.
砕く	くだく	to break, to smash.
砕ける	くだける	to break (into pieces), to be broken, to be smashed., to collapse, to crumble, to decline, to cool (e.g. enthusiasm), to dampen (e.g. one's will to fight)., to become less formal, to throw off reserve, to become affable., to become easy to understand (e.g. a story)., to be worried.
祭日	さいじつ	national holiday, festival day.
擦る	こする	to rub, to scrub.
殺気	さっき	thirst for blood.
雑巾	ぞうきん	house-cloth, dust cloth.
錆びる	さびる	to rust, to become rusty.
撒く	まく	to scatter, to sprinkle, to strew., to distribute (handbills, etc.), to spread (rumours, etc.)., to give the slip, to throw off, to shake off, to lose.
散らかす	ちらかす	to scatter around, to leave untidy.
四つ角	よつかど	four corners, crossroads.
始めに	はじめに	to begin with (used as an introduction), first of all, in the beginning.
室	しつ	room., wife (of someone of high rank)., scabbard., Chinese "Encampment" constellation (one of the 28 mansions).
疾っくに	とっくに	long ago, already, a long time ago.
実	み	fruit, nut., seed., (in broth) pieces of meat, vegetable, etc.., content, substance.
射す	さす	to shine.
煮える	にえる	to boil, to cook, to be cooked.
取り入れる	とりいれる	to harvest, to reap., to take in, to gather in., to adopt, to incorporate, to accept, to introduce.
蹴る	ける	to kick., to refuse, to reject.
従姉妹	いとこ, じゅうしまい	cousin (female).
重たい	おもたい	heavy, massive, serious, important, severe, oppressed.
縮める	ちぢめる	to shorten, to reduce, to boil down, to shrink.
縮れる	ちぢれる	to be wavy, to be curled.
出鱈目	でたらめ, デタラメ	irresponsible utterance, nonsense, bullshit, codswallop., random, haphazard, unsystematic.
諸	しょ	various, many, several.
小数	しょうすう	fraction (part of), decimal fraction.
消防署	しょうぼうしょ	fire station.
状	じょう	shape, state., letter, correspondence.
畳	じょう	counter for tatami mats., measure of room size (in mat units).
畳む	たたむ	to fold (clothes)., to close (a shop)., to vacate.
拭く	ふく	to wipe, to dry.
尻尾	しっぽ, しりお	tail (animal).
振り	ぶり	style, manner., after (period of time) again (e.g. meeting again after a year), for the first time in (period of time).
振り仮名	ふりがな	furigana (kana over or beside kanji to indicate pronunciation).
振り向く	ふりむく	to turn one's face, to turn around, to look over one's shoulder.
真似る	まねる	to mimic, to imitate.
瀬戸物	せともの, セトモノ	earthenware, crockery, china.
整数	せいすう	integer, whole number.
清書	せいしょ	clean copy.
生える	はえる	to grow, to spring up, to sprout., to cut (teeth).
生ずる	しょうずる	to produce, to yield, to cause., to result from, to arise, to be generated.
絶えず	たえず	constantly, always, continually, steadily.
千切る	ちぎる	to tear to pieces, to tear to shreds, to tear up., to pick (e.g. fruit), to pluck, to tear off., to do ... heavily, to do ... heartily, to do ... vigorously.
尖る	とがる, とんがる	to taper to a point, to become sharp., to look displeased, to look sour, to be on edge, to be touchy.
羨ましい	うらやましい	envious (feeling, etc.), jealous., enviable (position, etc.).
前	ぜん	the last (i.e. immediately preceding) (e.g. "the last mayor"), previous, one-time, former., (before the name of an era) pre- (e.g. "premodern")., before, earlier.
漸く	ようやく	finally, at last., barely, narrowly, hardly, only just., gradually, little by little, by degrees.
全	ぜん	all, whole, entire, complete, overall., pan-, omni-, toti-.
遡る	さかのぼる	to go upstream., to go back (in time, to origin), to date back to, to trace back to, to make retroactive.
爽やか	さわやか	fresh, refreshing, invigorating, clear, fluent, eloquent.
掃く	はく	to sweep, to brush, to gather up.
掻く	かく	to scratch., to perspire., to shovel, to paddle.
総	そう	whole, all, general, gross, entire, overall.
送り仮名	おくりがな	kana written after a kanji to complete the full (usually kun) reading of the word (may inflect), declensional kana ending.
憎らしい	にくらしい	odious, hateful.
其れなら	それなら	If that's the case ..., If so ..., That being the case ....
揃う	そろう	to become complete, to be all present, to be a full set, to have everything at one's disposal., to be equal, to be uniform., to gather, to assemble.
揃える	そろえる	to collect, to gather, to get together, to complete (a collection)., to arrange, to put in order, to prepare, to get ready., to make uniform, to make even, to match.
待合室	まちあいしつ	waiting room.
大して	たいして	(not so) much, (not) very.
大人しい	おとなしい	obedient, docile, quiet.
大層	たいそう	very much, exaggerated, very fine.
第一	だいいち	first, foremost, number one.
但し	ただし	but, however, provided that.
単数	たんすう	singular number.
仲直り	なかなおり	reconciliation, make peace with.
通り掛かる	とおりかかる	to happen to pass by.
潰す	つぶす	to smash, to crush., to shut down., to thwart, to block., to kill (time)., to waste (e.g. talents).
潰れる	つぶれる	to be smashed., to become useless, to cease functioning., to go bankrupt.
吊るす	つるす	to hang, to hang up.
吊る	つる	to hang, to suspend (something from something), to be hanged (by the neck)., to hoist an opponent off of his feet by his loincloth.
釣り合う	つりあう	to balance, to be in harmony, to suit, to go well together, to counterbalance, to reach equilibrium.
剃刀	かみそり, かみすり, そり, カミソリ	razor.
梯子	はしご, ていし, ハシゴ	ladder., stairs., going to several places in succession (e.g. barhopping).
纏める	まとめる	to collect, to put (it all) together, to integrate, to consolidate, to unify., to summarize, to aggregate., to bring to a conclusion, to finalize, to settle, to put in order., to establish, to decide.
兎も角	ともかく	anyhow, anyway, somehow or other, generally speaking, in any case, be that as it may.
吐く	つく	to breathe out, to breathe., to tell (a lie), to use (foul language)., to vomit, to throw up, to spit up.
凍える	こごえる	to freeze, to be chilled, to be frozen.
当てはまる	あてはまる	to apply (a rule), to be applicable, to come under (a category), to fulfill.
頭	とう	counter for large animals (e.g. head of cattle).
憧れる	あこがれる	to long for, to yearn after, to admire, to be attracted by.
独りでに	ひとりでに	by itself, automatically, naturally.
突き当たり	つきあたり	end (e.g. of street, hallway, etc.).
日の入り	ひのいり	sunset.
濡らす	ぬらす	to wet, to soak, to dip.
捻る	ひねる	to twist, to wrench, to turn (a switch on or off, etc.), to wring (a neck)., to puzzle over., to defeat easily.
覗く	のぞく	to peek (though a keyhole, gap, etc.)., to look down into (a ravine, etc.)., to peek into (a shop, bookstore, etc.)., to sneak a look at, to take a quick look at., to peep (through a telescope, microscope, etc.)., to stick out (a scarf from a collar, etc.), to peek through (sky through a forest canopy, etc.).
破れる	やぶれる	to get torn, to tear, to rip, to break, to wear out., to be broken off (of negotiations, etc.), to break down, to collapse, to fall into ruin.
売り切れ	うりきれ	sold-out.
売り切れる	うりきれる	to be sold out.
這う	はう	to creep, to crawl.
秤	はかり	scales, weighing machine.
剥く	むく	to peel, to skin, to pare, to hull, to bare (e.g. fangs), to open wide (e.g. eyes).
判子	はんこ	seal (used for signature).
番目	ばんめ	indicates position in a sequence., divisions of a kabuki performance.
被せる	かぶせる	to cover (with something), to put on (e.g. on someone else's head), to plate something (with a metal), to pour or dash a liquid (on something), to charge (a person with a guilt).
非	ひ	fault, error, mistake., going poorly, being disadvantageous, being unfavorable., un-, non-, an-.
肘	ひじ	elbow.
必需品	ひつじゅひん	necessities, necessary article, requisite, essentials, staple.
敷く	しく	to spread out, to lay out., to take a position., to impose widely (e.g. over a city).
浮く	うく	to float., to become merry, to be cheerful., to become loose, to become unsteady., to feel out of it, to be cut off (e.g. from those around you), to feel out of place., to be frivolous, to be uncertain., to have (time, money, etc.) left over, to be saved (e.g. money)., to have no basis, to be unreliable.
撫でる	なでる	to brush gently, to stroke, to caress.
部	ぶ	department (in an organization), division, bureau., club., part, component, element., category., counter for copies of a newspaper or magazine.
風	ふう	method, manner, way, style., appearance, air., tendency., folk song (genre of the Shi Jing)., wind (one of the five elements).
風呂敷	ふろしき	wrapping cloth, cloth wrapper.
副	ふく	assistant, associate, vice-, sub-, deputy, substitute, auxiliary, supplementary, additional, collateral., duplicate, copy., adverb.
副詞	ふくし	adverb.
物凄い	ものすごい	earth-shattering, staggering, to a very great extent., terrible, frightful, horrible, ghastly.
分数	ぶんすう	fraction.
呆れる	あきれる	to be amazed, to be shocked, to be astonished, to be astounded, to be disgusted.
放れる	はなれる	to get free, to be freed, to be released.
毎	ごと	each respectively.
毎	まい	every (usu. with events, e.g. every weekend), each.
明くる	あくる	next, following.
銘々	めいめい	each, individual.
目茶苦茶	めちゃくちゃ, メチャクチャ	absurd, unreasonable, nonsensical, preposterous, incoherent., extreme, senseless, reckless, wanton., disorder, confusion, mess, wreck.
儲かる	もうかる	to be profitable, to yield a profit.
儲ける	もうける	to profit, to get, to earn, to gain., to have (bear, beget) a child., to have a stroke of luck.
溶く	とく	to dissolve (paint), to scramble (eggs), to melt (metal, etc.), to mix (water with flour, etc.).
溶ける	とける	to melt, to thaw, to fuse, to dissolve.
略す	りゃくす	to abbreviate, to omit., to take, to capture.
流	りゅう	fashion, way, style, manner., school (of thought)., class, rank, rate.
流行る	はやる	to be popular, to come into fashion., to be prevalent, to spread widely (e.g. disease), to be endemic., to flourish, to thrive.
流石	さすが	as one would expect., still, all the same., even... (e.g. "even a genius...").
溜める	ためる	to amass, to accumulate, to store., to leave unpaid.
溜まる	たまる	to collect, to gather, to save, to accumulate, to pile up.
料	りょう	fee, charge, rate., material.
涼む	すずむ	to cool oneself, to cool off, to enjoy evening cool.
力	りょく	strength, power, proficiency, ability.
冷ます	さます	to cool (e.g. from a high temperature to room temperature), to let cool., to dampen, to throw a damper on, to spoil.
零す	こぼす	to spill, to drop, to shed (tears)., to grumble, to complain., to let one's feelings show.
零れる	こぼれる	to spill, to fall out of, to overflow., to peek through, to become visible (although normally not)., to escape (of a smile, tear, etc.).
煉瓦	れんが, レンガ	brick.
朗らか	ほがらか	bright, cheerful, melodious.
蝋燭	ろうそく, ローソク, ロウソク	candle.
和	わ	sum., harmony, peace., Japan, Japanese-style.
凭れる	もたれる	to lean against, to lean on, to recline on., to lie heavy (on the stomach), to be uneasily digested.
嗅ぐ	かぐ	to sniff, to smell.
囁く	ささやく	to whisper, to murmur., to rumor, to rumour.
嵌める	はめる	to insert, to put in (such that there is a snug fit), to button, to put on (something that envelops, e.g. gloves, ring)., to have sex, to fuck., to pigeonhole (into a particular category)., to place a ring-shaped object around something (esp. one that restricts freedom, such as handcuffs)., to entrap, to set someone up (i.e. frame them for a crime, etc.).
巫山戯る	ふざける	to joke, to jest, to kid, to josh., to make fun of, to laugh at, to play a prank., to romp, to gambol, to frolic, to frisk, to mess around, to fool around, to screw around., to neck, to make out.
箒	ほうき	broom.
拵える	こしらえる, こさえる	to make, to manufacture.
揉む	もむ	to rub, to crumple (up), to wrinkle, to massage, to be troubled about, to worry over, to train, to coach.
揶揄う	からかう	to ridicule, to tease, to mock, to chaff, to razz, to banter with, to make fun of, to poke fun at, to make cracks about.
狡い	ずるい, こすい	sly, cunning, dishonest, sneaky, crafty, unfair., miserly.
痒い	かゆい, かいい	itchy, itching.
痺れる	しびれる	to become numb, to go to sleep (e.g. a limb)., to be excited, to be titillated, to be mesmerized.
眩しい	まぶしい, まぼしい	dazzling, radiant.
目眩	めまい, げんうん	dizziness, giddiness, vertigo.
睨む	にらむ	to glare at, to scowl at, to glower at., to stare intensely at, to examine carefully., to estimate, to guess, to suspect, to judge., to keep an eye on someone (e.g. a suspicious or untrustworthy person), to watch., to take account of, to take into consideration.
臍	へそ, おへそ, ほぞ, ヘソ	navel, belly button.
茹でる	ゆでる	to boil.
諄い	くどい	verbose, importunate, wordy, repetitious, long-winded., heavy (taste), rich, strong, cloying, gaudy, loud.
躊躇う	ためらう	to hesitate.
躓く	つまずく, つまづく	to stumble, to trip., to fail.
頷く	うなずく, うなづく	to nod, to bow one's head in assent, to agree.
饂飩	うどん, うんどん, ウドン	udon, thick Japanese wheat noodles.
騙す	だます	to trick, to cheat, to deceive.
黴	かび, カビ	mold, mould, mildew.
逸れる	それる	to turn aside, to turn away, to veer away, to bear off., to miss (e.g. of a bullet), to go astray, to go wild., to deviate (e.g. of a conversation), to digress, to stray, to wander.
傾く	かたむく, かたぶく	to incline toward, to slant, to lurch, to heel over, to be disposed to, to trend toward, to be prone to., to go down (sun), to wane, to sink, to decline.
宛名	あてな	(addressee's) name, (recipient's) name and address.
当てはめる	あてはめる	to apply, to adapt.
愈々	いよいよ	more and more, all the more, increasingly., at last, finally, beyond doubt., (at the) last moment, worst possible time.
御数	おかず, おさい, オカズ	accompaniment for rice dishes, side dish., food for thought (esp. in the context of conversation, or material for assisting arousal during masturbation).
お八つ	おやつ	between-meal snack., mid-afternoon (around 3 o'clock) snack, afternoon refreshment, afternoon tea.
掛け算	かけざん	multiplication.
仮名	かな	kana, Japanese syllabary (e.g. hiragana, katakana).
気を付ける	きをつける	to be careful, to pay attention, to take care.
言付ける	ことづける	to send word, to send a message., to make an excuse, to make a pretext of.
逆様	さかさま	inversion, upside down.
明明後日	しあさって	(in) three days time (two days after tomorrow).
退く	どく, のく	to step aside, to move (i.e. out of the way), to make way., to resign, to retire, to quit, to secede.
好き好き	すきずき	matter of taste.
図々しい	ずうずうしい	impudent, shameless.
折角	せっかく	with trouble, at great pains., rare, valuable, precious, long-awaited., kind., specially, especially, expressly.
算盤	そろばん, ソロバン	abacus.
炊く	たく	to cook (grains, e.g. rice)., to boil, to simmer, to stew, to seethe.
焚く	たく	to burn, to kindle, to build a fire., to heat (a bath, stove, etc.)., to use (a camera flash).
謎々	なぞなぞ	riddle, puzzle, enigma.
何となく	なんとなく, なにとなく	somehow or other, for some reason or another, vaguely.
俄	にわか	sudden, abrupt, unexpected, improvised, offhand.
暢気	のんき, ノンキ	carefree, optimistic, careless, reckless, heedless, happy-go-lucky, easygoing, thoughtless.
剥がす	はがす, へがす	to tear off, to peel off, to rip off, to strip off, to skin, to flay, to disrobe, to deprive of, to detach, to disconnect.
人差し指	ひとさしゆび	index finger.
一まず	ひとまず	for the present, once, in outline.
塞がる	ふさがる, ふたがる	to be closed, to be blocked, to be healed (e.g. wound), to be shut up., to be clogged, to be plugged up., to be occupied, to be taken (e.g. accommodation).
塞ぐ	ふさぐ	to stop up, to close up, to block (up), to plug up, to shut up, to cover (ears, eyes, etc.), to close (eyes, mouth)., to stand in the way, to obstruct., to occupy, to fill up, to take up., to perform one's role, to do one's duty., to feel depressed, to mope.
真っ黒	まっくろ	pitch black.
勿体ない	もったいない	impious, profane, sacrilegious., too good, more than one deserves, unworthy of., wasteful.
薬缶	やかん	kettle.
余所	よそ	another place, somewhere else, strange parts., outside (one's family or group), those people., unrelated matter.
湧く	わく	to well (up), to gush forth (of water), to spring out, to surge., to appear (esp. suddenly) (sweat, tears, etc.)., to feel emotions form (joy, bravery, etc.)., to hatch (esp. of parasitic insects, etc.).
詫びる	わびる	to apologize, to apologise.
割り算	わりざん	division.
目出度い	めでたい	happy, auspicious, propitious, joyous., naive.
扇ぐ	あおぐ	to fan., to incite, to instigate.
欧米	おうべい	Europe and America, the West.
罹る	かかる	to suffer from.
貸間	かしま	room to let, room for rent.
紙屑	かみくず	wastepaper, paper scraps, paper waste.
注す	さす	to pour, to add (liquid), to serve (drinks)., to put on (lipstick, etc.), to apply, to colour, to dye., to light (a fire), to burn.
済まない	すまない	inexcusable, unjustifiable, unpardonable., sorry, remorseful, apologetic, conscience-stricken, contrite., excuse me, (I'm) sorry, thank you.
所為	せい, せえ	consequence, outcome, result, blame.
是非とも	ぜひとも	by all means (with sense of not taking "no" for an answer).
ブラシ		brush., brushy.
纏まる	まとまる	to be collected, to be settled, to be in order.
恵まれる	めぐまれる	to be blessed with, to be rich in, to abound in.
湯のみ	ゆのみ	teacup.
割合に	わりあいに	comparatively.
彼此	あれこれ, かれこれ	one thing or another, this and that, this or that., just on, nearly, roughly, almost, round about.
お休み	おやすみ	holiday, day off, absence., sleep, rest., Good night.
ちり紙	ちりがみ	tissue paper, toilet paper.
お帰り	おかえり	return., welcome home.
お代わり	おかわり	second helping, another cup, seconds., command to have dog place its second paw in one's hand.
お早う	おはよう	good morning.
馬鹿らしい	ばからしい	absurd.
やっ付ける	やっつける	to beat, to attack (an enemy), to do away with, to finish off.
そう言えば	そういえば	which reminds me ..., come to think of it ..., now that you mention it ..., on that subject ..., so, if you say ....
内	ない	inside, within.
外	がい	outside of, not covered by.
吐く	はく	to vomit, to throw up, to spit up., to emit, to send forth, to breathe out., to give (an opinion), to make (a comment), to express, to tell., to confess.
載る	のる	to be placed on, to be set on, to be piled on, to be loaded on., to appear (in print), to be mentioned, to be recorded, to be reported, to be given.
止まる	とどまる	to remain, to abide, to stay (in the one place)., to be limited to, to be confined to.
専制	せんせい	despotism, autocracy.
耕地	こうち	arable land.
夜行	やこう, やぎょう	walking around at night, night train, night travel.
請う	こう	to beg, to ask, to request, to invite.
見慣れる	みなれる	to become used to seeing, to be familiar with.
特長	とくちょう	forte, merit.
習字	しゅうじ	penmanship.
正味	しょうみ	net (weight).
悔やむ	くやむ	to mourn, to lament., to be sorry, to regret, to repent.
ウェイトレス		waitress.
加速度	かそくど	acceleration.
挟まる	はさまる	to get between, to be caught in.
針路	しんろ	course, direction, compass bearing.
憎い	にくい	hateful, abominable, poor-looking, detestable., amazing, fantastic, admirable, lovely, wonderful.
期	き	period, time., age.
合流	ごうりゅう	confluence (of rivers), merge (of traffic), conflux, junction, joining., union (e.g. of forces), linking up, merging, coming together.
足袋	たび	tabi, Japanese socks (with split toe).
御覧	ごらん	(please) try to., (please) look., seeing, looking, watching.
坊や	ぼうや	boy.
主語	しゅご	subject.
激増	げきぞう	sudden increase.
同格	どうかく	the same rank, equality, apposition.
台詞	せりふ, かはく, セリフ	speech, words, one's lines, remarks.
調度	ちょうど	supplies, furniture, fixtures.
部首	ぶしゅ	radical (of a kanji character).
速力	そくりょく	speed.
楕円	だえん	ellipse.
うっかり		carelessly, thoughtlessly, inadvertently.
うろうろ		loiteringly, aimless wandering, restlessly.
ええと		let me see, well, errr ....
ぎっしり		tightly, fully.
こっそり		stealthily, secretly.
さっさ		promptly, immediately, quickly, without delay., indifferently.
しつこい		insistent, obstinate, persistent, tenacious., too rich (taste, etc.), fatty, heavy, greasy.
しゃがむ		to squat, to crouch.
すっきり		feeling refreshed, feeling fine, feeling clear-headed., shapely, neatly, refinedly., cleanly, without trouble., clearly, plainly, distinctly., completely, thoroughly., not at all (with negative sentence), not even slightly.
滑らす	ずらす	to shift, to slide (e.g. something away from something else), to move (e.g. something out of the way)., to put off, to delay, to postpone, to stagger (e.g. working hours).
ずれる		to slide, to slip off, to get dislocated, to be out of alignment, to get dislodged, to deviate, to shift (position), to be out of sync., to be slightly off, to be off-point.
せめて		at least, at most.
そそっかしい		careless, thoughtless.
だらけ		implying (negatively) that something is full of (e.g. mistakes)., covered all over (e.g. with blood).
だらし無い	だらしない	slovenly, loose, sluttish, slatternly, untidy, undisciplined, careless.
どうせ		anyhow, in any case, at any rate, after all, at best, at most, at all.
のろのろ		slowly, sluggishly.
ぴかぴか		glitter, sparkle.
打つかる	ぶつかる	to strike against, to collide with, to bump into, to conflict., to encounter, to meet., to clash.
ぶつぶつ		grunt, grumble, complaint, mutter., pimples, spots, eruption, rash., cutting into small pieces., simmering.
まあまあ		so-so., now, now (used in calming people down)., my, my (expression of wonder, surprise, etc.).
まごまご		confused.
めっきり		remarkably.
イコール		equal., the equality sign (=)., equals (A equals B).
ウーマン		woman.
エプロン		apron.
オイル		oil, engine oil, kerosene.
ガム		chewing gum., gum, rubber.
ギャング		gang., gangster.
コーラス		chorus.
コレクション		collection., correction.
サンプル		sample.
ショップ		shop.
スカーフ		scarf.
ストッキング		stockings.
ゼミ		seminar.
ダイアグラム		diagram.
チップ		gratuity, tip., chip.
テニスコート		tennis court.
ドット		dot, point., polka dots., pixel.
バンド		band., to perform in a band, to create a (pop) band., The Bund (Shanghai, China).
ビルディング		building.
フリー		free., freelance.
フワフワ		lightly (floating, drifting, etc.), buoyantly., soft, fluffy, spongy., unsteadily, flightily, fickly, frivolously.
ブローチ		brooch.
ヘル		hell., Mr.
ペンチ		pliers.
モノレール		monorail.
レインコート		raincoat, mackintosh, macintosh, trench coat.
焦がす	こがす	to burn, to scorch, to singe, to char.
零点	れいてん	zero, no marks.
養分	ようぶん	nourishment, nutrient.
泊	はく	counter for nights of a stay.
せっせと		diligently, assiduously, industriously, beavering away.
みたい		-like, sort of, similar to, resembling.
なんて		such as, (things) like., exclamation.
ひとり子	ひとりご	(an) only child.
済み	ずみ, すみ	arranged, taken care of, settled, completed.
構いません	かまいません	no problem, it doesn't matter.
直流	ちょくりゅう	direct current, DC.
模試	もし	mock examination, trial examination.
斬る	きる	to kill (a human) using a blade (sword, machete, knife, etc.), to slice (off), to lop (off), to cut (off).
話し中	はなしちゅう	busy (phone).
最	さい	the most, the extreme., prime, conspicuous.
仕上がる	しあがる	to be finished, to be completed, to be done.
煎る	いる	to parch, to fry, to fire, to broil, to roast, to boil down (in oil).
歌留多	かるた, カルタ	karuta, traditional Japanese playing cards.
何々	なになに	such and such (when being vague, placeholder, etc.), this and that., What?, What is the matter?, What are the items?.
言いつける	いいつける	to tell (to do), to order, to charge, to direct., to tell on (someone), to report., to often say.
飽くまで	あくまで	to the end, to the bitter end, to the last, stubbornly, persistently, consistently, to the utmost., after all, it must be remembered, only, purely, simply.
螺子	ねじ, らし	screw., key (of a clock, watch, etc.), spring (of a clock, watch, etc.).
咥える	くわえる	to hold in one's mouth.
齧る	かじる	to chew, to bite (at), to gnaw, to nibble, to munch, to crunch, to have a smattering of., to dabble in (e.g. hobby, instrument).
お構いなく	おかまいなく	please don't fuss over me.
お邪魔します	おじゃまします	excuse me for disturbing (interrupting) you, greeting used when entering someone's home.
お世話になる	おせわになる	to receive favor (favour), to be much obliged to someone, to be indebted, to be grateful.
お先に	おさきに	before, previously., ahead., Pardon me for leaving (before you).
お待ち遠様	おまちどおさま	I'm sorry to have kept you waiting.
此間	こないだ	the other day, lately, recently.
沁み沁み	しみじみ	earnestly, keenly, fully, deeply, heartily, seriously., calmly.
しゃぶる		to suck, to chew.
じゃん拳	じゃんけん	rock, paper, scissors game.
その為	そのため	hence, for that reason.
どうぞ宜しく	どうぞよろしく	pleased to meet you.
どっと		suddenly.
はきはき		briskly, smartly, promptly, clearly, lucidly.
オーバコート		overcoat.
タイア		tire, tyre.
ダブる		to be duplicated, to be repeated., to overlap, to fall together (of dates, etc.), to coincide., to repeat (a failed course, school year, etc.)., to make a double play., to make a double fault (in tennis).
下線	かせん	underline, underscore.
火口	かこう	crater, caldera., burner (e.g. on a furnace).
寒帯	かんたい	frigid zone.
関東	かんとう	Kanto (eastern half of Japan, including Tokyo).
形容動詞	けいようどうし	na-adjective (adj-na), quasi-adjective, adjectival noun, nominal adjective.
繋げる	つなげる	to tie, to fasten, to connect, to transfer (phone call).
古	ふる	used item, secondhand item., old, used, previous.
今	こん	the current ..., this., today's ....
昨	さく	last (year), yesterday.
仕様が無い	しようがない, しょうがない	it can't be helped, it is inevitable, nothing can be done, there's no point (in doing something), there's no reason (to do something).
酌む	くむ	to serve sake.
お出掛け	おでかけ	about to start out, just about to leave or go out.
述語	じゅつご	predicate.
順々	じゅんじゅん	in order, in turn.
女	じょ	woman, girl, daughter., Chinese "Girl" constellation (one of the 28 mansions).
女の人	おんなのひと	woman.
勝手に	かってに	arbitrarily, of its own accord, involuntarily, wilfully, willfully, as one pleases.
上	うわ	upper, upward, outer, surface, top.
拙い	つたない, まずい	poor-quality, shoddy, crude., unskillful, inexpert, maladroit, inept, foolish, clumsy., unlucky.
占めた	しめた	I've got it, all right, fine.
羨む	うらやむ	to envy.
挿す	さす	to insert, to put in., to plant (a cutting), to strike., to arrange (flowers)., to wear (a sword) in one's belt., to shut, to close, to lock, to fasten.
大よそ	おおよそ	about, roughly, as a rule, approximately.
第	だい	ordinal.
帳	ちょう	book, register.
直	なお	ordinary, common., doing nothing.
お目にかかる	おめにかかる	to meet (someone of higher status).
率土	そっと	face of the earth.
碗	わん	bowl (ceramic, porcelain).
炙る	あぶる	to warm (i.e. one's hands over a fire), to dry., to scorch, to broil, to toast, to grill.
襤褸	ぼろ, らんる	rag, scrap, tattered clothes, fault (esp. in a pretense, pretence), defect, run-down or junky.
一昨昨日	いっさくさくじつ, さきおとつい, さきおととい	two days before yesterday, three days back (ago).
等	とう	class, order, rank., et cetera, etc., and the like., equal, iso-.
佚	いつ	being comfortable, relaxing.
粗	あら	leftovers (after filleting a fish)., rice chaff., flaw (esp. of a person)., rough, roughly., crude, raw, natural, wild.
仕舞い	しまい	end, close, finish, termination., noh dance in plain clothes.
すれ違う	すれちがう	to pass by one another, to disagree, to miss each other.
先々月	せんせんげつ	month before last.
点々	てんてん	here and there, little by little, sporadically, scattered in drops, dot, spot.
ひっくり返す	ひっくりかえす, ひっくりがえす	to turn over, to turn upside down, to turn up, to turn inside out, to turn out., to knock over, to tip over., to overturn (e.g. a decision), to upset, to reverse.
広々	ひろびろ	extensive, spacious.
潜る	もぐる, むぐる	to dive (into or under water)., to get under, to get into, to get in, to creep into, to crawl under, to bury oneself, to burrow into, to dig oneself into, to snuggle under., to hide oneself (esp. from the government), to conceal oneself, to go underground.
しーん		silently (as the grave), quietly (as in death).
傾らか	なだらか	gently-sloping, gentle, easy.
屍蝋	しろう	adipocere, grave wax (greying of the body fats of a corpse which rests in a moist but airless place) (graying).
お目出度い	おめでたい	special, auspicious, happy., naive, innocent, good-natured, gullible, foolish.
無沙汰	ぶさた	not writing or contacting for a while, neglecting to write (call, visit, etc.), failing to write (call, visit, etc.), long silence.
攻め手	せめて	offense, offence, method of attack.
蕩蕩	とうとう	vast, calm.
気味	ぎみ	-like, -looking, -looked, tending to ....
洋品店	ようひんてん	shop that handles Western-style apparel and accessories.
先先週	せんせんしゅう	week before last.
店屋	みせや	store, shop.
縒り	より	twist, ply.
団	だん	body, group, party, company, troupe.
論	ろん	argument, discussion, dispute, controversy, discourse, debate., theory (e.g. of evolution), doctrine., essay, treatise, comment.
割りと	わりと	relatively, comparatively.
存ずる	ぞんずる	to think, feel, consider, know, etc..
茶色い	ちゃいろい	light brown, tawny.
通ずる	つうずる	to be open (to traffic), to lead to, to communicate (with)., to flow (liquid, current), to pass, to get through to., to be understood, to be comprehended., to be honored, to be good., to be well versed in, to be well-informed., to communicate clandestinely, to keep in touch (e.g. with the enemy)., to form a liaison, to be intimate.
破く	やぶく	to tear, to violate, to defeat, to smash, to destroy.
バイバイ		bye-bye, good-bye, see you, so long., saying goodbye, parting.
うんと		a great deal, very much, a lot., with a great amount of effort.
斯うして	こうして	thus, in this way.
ずらり		in a row.
密	みつ	density, thickness., secrecy., minute, fine.
社	しゃ	company, association, society., regional Chinese god of the earth (or a village built in its honour)., counter for companies, shrines, etc..
勝ち	がち	apt to do, liable to do, tend to do (used to describe a negative tendency).
画	が, え	picture, drawing, painting, sketch.
機	き	chance, opportunity., machine., aircraft., counter for aircraft., counter for remaining lives (in video games).
隻	せき	counter for ships (large boats)., counter for half of a pair (e.g. half of a folding screen)., counter for fish, birds, arrows, etc..
それなのに		and yet, despite this, but even so, but even then, however, nevertheless, for all that, notwithstanding that.
現	げん	present (e.g. government, administration), current, existing.
化	か	action of making something, -ification.
翌	よく	the following, next.
等	ら	pluralizing suffix, and others, and the like, and followers, et al.., or so., nominalizing suffix.
偶	たま	occasional, rare.
空	くう	empty air, sky., shunya (emptiness, the lack of an immutable intrinsic nature within any phemomenon)., air force., fruitlessness, meaninglessness., void (one of the five elements).
両	りょう	both (e.g. both shoulders, etc.)., ryo (obsolete unit of currency)., 41-42 g (one sixteenth of a kin)., 2 tan (measure of fabric size)., counter for carriages (e.g. in a train), counter for vehicles.
戦	せん	war, battle., match, competition.
史	し	history (e.g. of some country).
暖か	あたたか, あったか	warm, mild, genial.
省	しょう	ministry, department., province (of China)., saving, conserving.
粗衣	そい	simple clothes, humble clothes.
大	おお	big, large.
領	りょう	territory of (country).
大	だい	the large part of., big, large, great., approximate size, no larger than., -university., large (e.g. serving size), loud (e.g. volume setting).
日	か	day of month., counter for days.
山	さん	Mt (suffix used with the names of mountains), Mount.
港	こう	harbour.
島	とう	Island., insula, island, islet.
斜	はす, しゃ	diagonal.
物	ぶつ, ブツ	stock, products., stolen goods, loot, spoils.
辛い	づらい, ずらい	difficult to (do something).
色	しょく	counter for colours.
産	さん	(giving) birth, childbirth, delivery, confinement., native of, product of., assets, property, fortune.
重	じゅう	multi-tiered food box, stacked boxes., heavy., serious, extreme., -fold, -ply.
器	き	device, instrument., vessel, container.
お世話	おせわ	help, aid, assistance.
業	ぎょう	work, business., study.
者	しゃ	someone of that nature, someone doing that work.
名	めい	counter for people (usu. seating, reservations and such)., first name., famous, great., name., noun.
付	づけ	dated (e.g. a letter), date of effect (e.g. a rule change).
道	どう	road., way., Buddhist teachings., Taoism., modern administrative region of Japan (Hokkaido)., historical administrative region of Japan (Tokaido, Tosando, etc.)., province (Tang-era administrative region of China)., province (modern administrative region of Korea).
下	か	under (being in said condition or environment).
お気の毒に	おきのどくに	my sympathies, that's too bad, my condolences.
属	ぞく	genus., generic.
高	こう	high school., high-.
×	ばつ, ぺけ, ペケ	x-mark (used to indicate an incorrect answer in a test, etc.)., impossibility, futility, uselessness.
明	みょう	vidya (wisdom)., mantra., the coming (4th of July, etc.).
遍	へん	number of times.
元	もと	former, ex-.
未	み	not yet, un-.
形	けい	form, tense., (true) adjective, i-adjective.
み		-ness (nominalizing suffix, esp. of sensory or subjective adjectives)., nominalizing suffix indicating location., (as ...mi ...mi) alternating between ... and ....
校	こう	school., proof (of a book, document, etc.), counter for proofs.
御	おん, ぎょ	honorific prefix., imperial, emperor.
小母さん	おばさん	old lady, ma'am (vocative).
寺	じ	counter for temples.
所	しょ	counter for places.
時間目	じかんめ	period (e.g. class).
其れと	それと	and then, even so, and.
お掛け下さい	おかけください	please sit down, please have a seat.
その頃	そのころ	at that time, in those days, at that moment, then.
五味	ごみ	five flavors (sweet, salty, spicy, sour, bitter), five palates, five tastes., five flavors (milk at various stages of making ghee: fresh milk, cream, curdled milk, butter, and ghee), the five periods of the Buddha's teachings.
ぴたり		tightly, closely., exactly, precisely., suddenly (stopping).
