出身	しゅっしん	person's origin (e.g. city, country, parentage, school).
誠に	まことに, じつに, げに, しんに	indeed, really, absolutely, truly, actually, very, quite.
故郷	ふるさと, こきょう, きゅうり	home town, birthplace, native place, one's old home.
合わせる	あわせる	to match (rhythm, speed, etc.)., to join together, to unite, to combine, to add up., to face, to be opposite (someone)., to compare, to check with., to cause to meet (e.g. an unpleasant fate)., to place together, to connect, to overlap., to mix, to combine., to put blade to blade, to fight.
明かり	あかり	light, illumination, glow, gleam., lamp, light.
現れ	あらわれ	embodiment, manifestation, materialization, materialisation, expression, indication.
撃つ	うつ	to shoot (at)., to attack, to defeat, to destroy, to avenge.
痛み	いたみ	pain, ache, soreness, grief, distress., damage, injury, wear, bruise, break.
計る	はかる	to measure, to weigh, to survey, to time (sound, gauge, estimate)., to conjecture, to infer, to surmise.
換える	かえる	to replace., to exchange, to interchange., to substitute.
畑	はたけ, はた	field (for fruits, vegetables, etc.), cultivated land, vegetable plot, kitchen garden, plantation., field (of specialization), sphere, area., womb, birth, birthplace.
共同	きょうどう	doing together (as equals), sharing, common (land, etc.), joint (statement, etc.), cooperation, co-operation, collaboration, association.
機械	きかい	machine, mechanism., instrument, appliance, apparatus.
文字	もじ, もんじ	letter (of alphabet), character., literal.
唯一	ゆいいつ, ゆいつ	only, sole, unique.
管	かん, くだ	pipe, tube.
保証	ほしょう	guarantee, security, assurance, pledge, warranty.
博士	はかせ, はくし	doctorate, PhD, Dr (as a title)., expert, learned person.
寄付	きふ	contribution, donation.
元	もと	origin, source., base, basis, foundation, root., cause., ingredient, material., (somebody's) side, (somebody's) location., original cost (or capital, principal, etc.)., (plant) root, (tree) trunk., first section of a waka., counter for blades of grass, tree trunks, etc., and for falcons (in falconry)., handle (chopsticks, brush, etc.), grip.
虎	とら, トラ	tiger (Panthera tigris)., drunkard, drunk, sot.
流行	はやり, りゅうこう	fashion, fad, vogue, craze., prevalence (e.g. of a disease).
祭	まつり	festival, feast.
日付	ひづけ	date, dating.
園	その, えん	garden (esp. man-made), orchard, park, plantation., place, location.
科目	かもく	(school) subject, curriculum, course.
越える	こえる	to cross over, to cross, to pass through, to pass over (out of)., to exceed.
行き	ゆき, いき	bound for ...., going (to).
梅雨	つゆ, ばいう	rainy season., rain during the rainy season.
勤め	つとめ	service, duty, business, responsibility, task., Buddhist religious services.
悪口	あっこう, わるくち, わるぐち	abuse, insult, slander, evil speaking, bad mouth.
現す	あらわす	to reveal, to show, to display., to express., to represent, to signify, to stand for., to make widely known.
只	ただ, タダ	ordinary, common, usual., free of charge., unaffected, as is, safe., only, merely, just, simply., but, however, nevertheless.
年月	としつき, ねんげつ	months and years.
羽	はね	feather, plume, wing., blade (fan, propeller, etc.).
戦う	たたかう	to fight, to battle, to combat, to struggle against, to wage war, to engage in contest.
出会う	であう	to meet (by chance), to come across, to run across, to encounter, to happen upon., to meet (e.g. of rivers, highways, etc.)., to emerge and engage (an enemy).
暖かい	あたたかい, あったかい	warm, mild, genial.
収める	おさめる	to dedicate, to make an offering, to pay (fees)., to supply., to store., to finish, to bring to a close., to restore (something to its place)., to achieve (e.g. a result).
小包	こづつみ	parcel, package.
出会い	であい	meeting, rendezvous, encounter., confluence.
備える	そなえる	to furnish, to provide for, to equip, to install., to have ready, to prepare for., to possess, to have, to be endowed with, to be armed with.
現れる	あらわれる	to appear, to come in sight, to become visible, to come out, to embody, to materialize, to materialise., to be expressed (e.g. emotions), to become apparent (e.g. trends, effects).
以来	いらい	since, henceforth.
委員	いいん	committee member.
維持	いじ	maintenance, preservation, improvement.
違反	いはん	violation (of law), transgression, infringement, breach.
医療	いりょう	medical care, medical treatment.
一般	いっぱん	general, universal., ordinary, average, common.
一方	いっぽう	one (esp. of two), the other, one way, the other way, one direction, the other direction, one side, the other side, one party, the other party., on the one hand, on the other hand., whereas, although, but at the same time, meanwhile, in turn., (after noun, adjective-stem or plain verb) just keeps, being inclined to ..., tending to be ..., tending to do ..., continuously ..., just keeps on ...ing, only.
影響	えいきょう	influence, effect., to influence, to affect, to have an influence on, to impact, to have an effect on.
援助	えんじょ	assistance, aid, support.
価格	かかく	price, value, cost.
可能	かのう	potential, possible, practicable, feasible.
過去	かこ	the past, bygone days, the previous., a past (i.e. a personal history one would prefer remained secret), one's past., past (tense), preterit, preterite., previous life.
会員	かいいん	member, the membership.
解決	かいけつ	settlement, solution, resolution.
回復	かいふく	restoration, rehabilitation, recovery, return, replevin, improvement., recovery (from an illness), recuperation, convalescence.
海外	かいがい	foreign, abroad, overseas.
外交	がいこう	diplomacy., selling (e.g. door-to-door), canvassing.
拡大	かくだい	magnification, enlargement, expansion, amplification.
活動	かつどう	action, activity.
患者	かんじゃ	(a) patient.
環境	かんきょう	environment, circumstance.
監督	かんとく	supervision, control, superintendence, direction., director, superintendent, supervisor, coach, foreman, manager, overseer, controller, boss.
管理	かんり	control, management (e.g. of a business).
関心	かんしん	concern, interest.
関連	かんれん	relation, connection, relevance.
企業	きぎょう	enterprise, undertaking, corporation, business.
基本	きほん	foundation, basis, standard.
期間	きかん	period, term, interval.
期待	きたい	expectation, anticipation, hope.
機関	きかん	engine., agency, organisation, organization, institution, organ, body., system, facility, facilities.
機能	きのう	function, facility, faculty, feature.
記事	きじ	article, news story, report, account.
記者	きしゃ	reporter.
記録	きろく	record, minutes, document., a record (e.g. in sports), results, score., to record, to document., to set a record (e.g. in sports), to show a result, to reach a value.
議員	ぎいん	member of the Diet, congress or parliament.
議会	ぎかい	Diet, congress, parliament.
議長	ぎちょう	chairman, speaker (e.g. of assembly), president (e.g. of council, senate, etc.), moderator (e.g. of a newsgroup).
教授	きょうじゅ	professor., teaching, instruction.
筋	すじ	muscle, tendon, sinew., vein, artery., fiber, fibre, string., line, stripe, streak., reason, logic., plot, storyline., lineage, descent., school (e.g. of scholarship or arts)., aptitude, talent., source (of information, etc.), circle, channel., well-informed person (in a transaction)., logical move (in go, shogi, etc.)., ninth vertical line (shogi)., seam on a helmet., gristly fish paste (made of muscle, tendons, skin, etc.)., on (a river, road, etc.), along., counter for long thin things, counter for roads or blocks when giving directions.
金融	きんゆう	financing, credit transacting, loaning of money, circulation of money.
契約	けいやく	contract, compact, agreement.
景気	けいき	condition, state, business (condition).
経営	けいえい	management, administration.
決定	けってい	decision, determination.
結果	けっか	result, consequence, outcome, effect., coming to fruition, bearing fruit.
建設	けんせつ	construction, establishment.
憲法	けんぽう	constitution.
現在	げんざい	now, current, present, present time, as of.
現実	げんじつ	reality.
現場	げんば, げんじょう	actual spot, scene, scene of the crime, site, location, setting., shop floor, factory floor, (on) site.
言わば	いわば	so to speak, so to call it, as it were.
個人	こじん	individual, private person, personal, private.
候補	こうほ	candidate, contender, prospect, pick, choice, list., candidacy, candidature, nomination.
効果	こうか	effect, effectiveness, efficacy, result.
攻撃	こうげき	attack, strike, offensive., criticism, censure, denunciation, condemnation.
考え	かんがえ	thinking, thought, view, opinion, concept., idea, notion, imagination., intention, plan, design., consideration, judgement, deliberation, reflection., wish, hope, expectation.
行動	こうどう	action, conduct, behaviour, behavior, mobilization, mobilisation.
国家	こっか	state, country, nation.
国会	こっかい	National Diet, parliament, congress.
国民	こくみん	nation, nationality, people, citizen.
今回	こんかい	now, this time, lately.
今後	こんご	from now on, hereafter.
最高	さいこう	highest, supreme, the most.
最終	さいしゅう	last, final, closing.
裁判	さいばん	trial, judgement, judgment.
作業	さぎょう	work, operation, manufacturing, fatigue duty.
作品	さくひん	work (e.g. book, film, composition, etc.), opus, performance, production.
参加	さんか	participation.
姿	すがた	figure, form, shape., appearance, dress, guise., state, condition, picture, image., form (of a waka)., dressed in ..., wearing ....
市場	いちば	(town) market., (the) marketplace.
指導	しどう	leadership, guidance, coaching., shido (disciplinary action for a minor infringement of the rules of judo).
事件	じけん	event, affair, incident, case, plot, trouble, scandal.
事実	じじつ	fact, truth, reality.
事情	じじょう	circumstances, consideration, conditions, situation, reasons, state of affairs.
事務	じむ	business, office work.
時期	じき	time, season, period, phase, stage., soon, shortly.
自身	じしん	by oneself, personally.
自然	しぜん	nature, spontaneity., naturally, spontaneously.
実施	じっし	enforcement, implementation, putting into practice, carrying out, operation, working (e.g. working parameters), enactment.
首相	しゅしょう	Prime Minister, Chancellor (Germany, Austria, etc.), Premier.
州	しゅう	state, province, county, department (of ancient China)., continent.
住宅	じゅうたく	residence, housing, residential building.
住民	じゅうみん	citizens, inhabitants, residents, population.
重要	じゅうよう	important, momentous, essential, principal, major.
女子	じょし, おなご, おみなご	woman, girl.
商品	しょうひん	commodity, article of commerce, goods, stock, merchandise.
情報	じょうほう	information, news, intelligence, advices., information, data contained in characters, signals, code, etc..
条件	じょうけん	condition, conditions, term, terms, requirement, requirements.
状況	じょうきょう	state of affairs (around you), situation, circumstances.
状態	じょうたい	current status, condition, situation, circumstances, state.
新た	あらた	new, fresh, novel.
人間	にんげん	human being, man, person., character (of a person).
人気	にんき	popularity, popular feeling, business conditions.
制度	せいど	system, institution, organization, organisation.
成長	せいちょう	growth, grow to adulthood.
政府	せいふ	government, administration.
積極的	せっきょくてき	assertive, positive, active, proactive.
責任	せきにん	duty, responsibility (incl. supervision of staff)., liability, onus.
選手	せんしゅ	player (in game), team member.
全体	ぜんたい	whole, entirety, whatever (is the matter).
組	くみ	set (of items)., group (of people), class (of students), company (esp. construction), family (i.e. mafia), team., typesetting, composition.
組織	そしき, そしょく	organization, organisation., structure, construction., tissue., system.
相手	あいて	companion, partner, company., other party, addressee., opponent (sports, etc.).
対象	たいしょう	target, object (of worship, study, etc.), subject (of taxation, etc.).
代表	だいひょう	representative, representation, delegation, type, example, model.
大会	たいかい	convention, tournament, mass meeting, rally.
大統領	だいとうりょう	president, chief executive.
団体	だんたい	organization, organisation, association.
男子	だんし	youth, young man.
知事	ちじ	prefectural governor.
地域	ちいき	area, region.
地球	ちきゅう	the earth, the globe.
地方	ちほう	district, region, area, locality., the country, countryside, the provinces, rural area.
中央	ちゅうおう	centre, center, middle, heart., metropolis, capital city, central government.
中心	ちゅうしん	center, centre, middle, heart, core, focus, pivot, emphasis, balance., -centered, -centred, -focussed, -oriented, centered on, focussed on.
調査	ちょうさ	investigation, examination, inquiry, enquiry, survey.
通信	つうしん	correspondence, communication, transmission, news, signal.
程度	ていど	degree, amount, grade, standard, of the order of (following a number).
都市	とし	town, city, municipal, urban.
努力	どりょく	great effort, exertion, endeavour, endeavor, effort.
土地	とち, どおじ, どじ, どち	plot of land, lot, soil.
投票	とうひょう	voting, poll.
当時	とうじ	at that time, in those days.
同時	どうじ	simultaneous(ly), concurrent, same time, synchronous, together.
内容	ないよう	subject, contents, matter, substance, detail, import.
年間	ねんかん	year (period of).
農業	のうぎょう	agriculture.
判断	はんだん	judgement, judgment, decision, adjudication, conclusion, decipherment, divination.
販売	はんばい, ハンバイ	sales, selling, marketing.
批判	ひはん	criticism, judgement, judgment, comment.
舞台	ぶたい	stage (theatre, theater)., scene or setting (e.g. of novel, play, etc.).
部分	ぶぶん	portion, section, part.
分野	ぶんや	field, sphere, realm, division, branch.
平和	へいわ	peace, harmony.
変化	へんか	change, variation, alteration, mutation, transition, transformation, transfiguration, metamorphosis., variety, diversity., inflection, declension, conjugation., sidestepping.
報告	ほうこく	report, information.
方向	ほうこう	direction, orientation, bearing, way., course (e.g. of action).
方法	ほうほう	method, process, manner, way, means, technique.
訪問	ほうもん	call, visit.
明らか	あきらか	obvious, evident, clear, plain.
目的	もくてき	purpose, goal, aim, objective, intention.
目標	もくひょう	mark, objective, target.
役割	やくわり	part, assigning (allotment of) parts, role, duties.
優勝	ゆうしょう	overall victory, championship.
予算	よさん	estimate, budget.
要求	ようきゅう	demand, firm request, requisition, requirement, desire.
立場	たちば	standpoint, position, situation.
連続	れんぞく	serial, consecutive, continuity, occurring in succession, continuing.
一時	いちじ	one o'clock., once, at one time, formerly, before., for a time, for a while, for the time being, for the present, for the moment, temporarily., a time, one time, once.
全国	ぜんこく	countrywide, nationwide, whole country, national.
平均	へいきん, へいぎん	average, mean., balance, equilibrium.
協力	きょうりょく	cooperation, collaboration.
銀	ぎん, しろがね, しろかね	silver (Ag)., silver coin, money., silver medal., silver colour (color)., silver general (shogi).
事態	じたい	situation, (present) state of affairs, circumstances.
労働	ろうどう	manual labor, manual labour, toil, work., Labour Party.
愛	あい	love, affection, care., attachment, craving, desire.
安定	あんてい	stability, equilibrium.
意識	いしき	consciousness., awareness, sense., mano-vijnana (mental consciousness, cognizer of sensory information).
違い	ちがい	difference, discrepancy.
医師	いし	doctor, physician.
宇宙	うちゅう	universe, cosmos, space.
営業	えいぎょう	business, trade, sales, operations.
衛星	えいせい	satellite.
演説	えんぜつ	speech, address.
会合	かいごう	meeting, assembly., association., conjunction.
改善	かいぜん	betterment, improvement., kaizen (Japanese business philosophy of continuous improvement).
開始	かいし	start, commencement, beginning, initiation.
確実	かくじつ	certainty, reliability, soundness.
感じ	かんじ	feeling, sense, impression.
観光	かんこう	sightseeing.
希望	きぼう	hope, wish, aspiration.
記念	きねん	commemoration, memory.
疑問	ぎもん	question, problem, doubt, guess.
議論	ぎろん	argument, discussion, dispute, controversy.
競技	きょうぎ	game, match, contest.
共通	きょうつう	commonness, community., to be common, to be shared., -wide.
教師	きょうし	teacher (classroom).
胸	むね, むな	chest, breast., breasts, bosom, bust., heart., lungs., stomach., heart, mind, feelings.
禁止	きんし	prohibition, inhibition, ban.
軍	ぐん	army, force, troops.
傾向	けいこう	tendency, trend, inclination.
芸術	げいじゅつ	(fine) art, the arts.
劇場	げきじょう	theatre, theater, playhouse.
結局	けっきょく	after all, eventually, in the end.
結論	けつろん	conclusion.
健康	けんこう	health, sound, wholesome.
検査	けんさ	inspection (e.g. customs, factory), examination, scan (e.g. MRI, PET, etc.).
検討	けんとう	consideration, examination, investigation, study, scrutiny, discussion, analysis.
権利	けんり	right, privilege.
見解	けんかい	opinion, point of view.
現状	げんじょう	present condition, existing state, status quo.
現代	げんだい	nowadays, modern era, modern times, present-day.
交換	こうかん	exchange, interchange, switching, reciprocity, barter, substitution, replacement, clearing (of checks, cheques).
広告	こうこく	advertisement.
航空	こうくう	aviation, flying.
講演	こうえん	lecture, address, speech.
国境	こっきょう, くにざかい, こっかい	national border, provincial border.
混乱	こんらん	disorder, chaos, confusion, mayhem.
差	さ	difference, variation.
再び	ふたたび	again, once more, a second time.
作家	さっか	author, writer, novelist, artist.
賛成	さんせい	approval, agreement, support, favour, favor.
使用	しよう	use, application, employment, utilization, utilisation.
思わず	おもわず	unintentionally, reflexively, spontaneously, involuntarily, instinctively.
支店	してん	branch office, branch store.
実験	じっけん	experiment.
実現	じつげん	implementation (e.g. of a system), materialization, materialisation, realization, realisation.
実際	じっさい	practicality, practical., reality, actuality, actual conditions., bhutakoti (limit of reality).
主義	しゅぎ	doctrine, rule, principle.
主張	しゅちょう	claim, request, insistence, assertion, advocacy, emphasis, contention, opinion, tenet.
主婦	しゅふ	housewife, mistress (of the house), homemaker.
主要	しゅよう	chief, main, principal, major.
首都	しゅと	capital city, metropolis.
需要	じゅよう	demand, request.
収入	しゅうにゅう	income, receipts, revenue.
宗教	しゅうきょう	religion, religious affiliation, belief, faith, creed., religious activity.
修正	しゅうせい	amendment, correction, revision, modification, alteration, retouching, update, fix.
集団	しゅうだん	group, mass.
処理	しょり	processing, dealing with, treatment, disposition, disposal.
少年	しょうねん	boy, juvenile, young boy, youth, lad.
承認	しょうにん	recognition, acknowledgement, acknowledgment, approval, consent, agreement.
消費	しょうひ	consumption, expenditure.
障害	しょうがい, しょうげ	obstacle, impediment, hindrance, difficulty, barrier., handicap, impairment, disability, disorder, malfunction.
深刻	しんこく	serious, severe, grave, acute.
身	み	body., oneself., one's place, one's position., main part, meat (as opposed to bone, skin, etc.), wood (as opposed to bark), blade (as opposed to its handle), container(as opposed to its lid).
人生	じんせい	(human) life (i.e. conception to death).
人物	じんぶつ	character, personality, person, man, personage, talented man.
推薦	すいせん	recommendation, referral, endorsement.
水準	すいじゅん	level, standard., water level.
数字	すうじ	numeral, figure, digit, numeric character.
正式	せいしき	due form, official, formality.
精神	せいしん	mind, soul, heart, spirit, intention.
製造	せいぞう	manufacture, production.
製品	せいひん	manufactured goods, finished goods, product.
石油	せきゆ	oil, petroleum, kerosene.
設備	せつび	equipment, device, facilities, installation.
全員	ぜんいん	all members (unanimity), all hands, the whole crew, everyone, everybody.
組合	くみあい	association, union, guild.
装置	そうち	equipment, installation, apparatus, device.
増加	ぞうか	increase, increment, addition.
存在	そんざい	existence, being.
態度	たいど	attitude, manner, behaviour.
逮捕	たいほ	arrest, apprehension, capture.
大使	たいし	ambassador.
担当	たんとう	being in charge (of an area of responsibility), being responsible (for a work role, etc.).
仲間	なかま	company, fellow, colleague, associate, comrade, mate, group, circle of friends, partner., member of the same category.
長期	ちょうき	long time period, long term.
直接	ちょくせつ	direct, immediate, personal, firsthand.
提案	ていあん	proposal, proposition, suggestion.
伝統	でんとう	tradition, convention.
党	とう	party (political)., faction, -ite.
同様	どうよう	identical, equal to, same (kind), like, similarity.
道路	どうろ	road, highway.
特徴	とくちょう	feature, trait, characteristic, pecularity, distinction.
独立	どくりつ	independence (e.g. Independence Day), self-support.
能力	のうりょく	ability, faculty.
馬	うま, いま, おま, ウマ	horse., promoted bishop (shogi).
発行	はっこう	issue (publications), publishing., raising an event (software).
発展	はってん	development, growth, advancement, unfurling., expansion, extension, enlargement., playing around, having an active sex life.
発表	はっぴょう	announcement, publication, presenting.
被害	ひがい	(suffering) damage, injury, harm.
費用	ひよう	cost, expense.
非常	ひじょう	emergency., extraordinary, unusual.
表現	ひょうげん	expression, presentation., representation, notation.
表情	ひょうじょう	facial expression, countenance.
評価	ひょうか	valuation, estimation, assessment, evaluation, rating., to value, to assess, to rate, to estimate value., to appreciate, to value highly, to acknowledge the value (of something).
不安	ふあん	anxiety, uneasiness, insecurity, suspense.
不足	ふそく	insufficiency, shortage, deficiency, lack, dearth.
不満	ふまん	dissatisfaction, displeasure, discontent, complaints, unhappiness, disgruntled.
夫人	ふじん, ぶにん, はしかし	wife, Mrs, madam.
父親	ちちおや	father.
武器	ぶき	weapon, arms, ordnance.
幅	はば	width, breadth., freedom (e.g. of thought), latitude., gap, difference (e.g. in price), range (e.g. of voice).
母親	ははおや	mother.
豊か	ゆたか	abundant, wealthy, plentiful, rich, affluent., very, extremely, full of, great.
本人	ほんにん	the person himself.
無料	むりょう	free, no charge.
名	な	name, given name., title., fame, renown, reputation., pretext, pretense, justification, appearance.
明確	めいかく	clear, precise, definite, distinct.
友人	ゆうじん	friend.
有効	ゆうこう	validity, legality, availability, effectiveness.
様子	ようす	state, state of affairs, situation, circumstances., appearance, look, aspect., sign, indication.
利益	りえき, りやく	profit, gains., benefit, advantage, interest (of the public, etc.)., grace (of God, Buddha, etc.) (esp. as attained through rightful actions, prayer, adherence to one's faith, etc.), blessing, miracle.
理解	りかい	understanding, comprehension, appreciation, sympathy.
流れ	ながれ	stream, current, flow.
料金	りょうきん	fee, charge, fare.
老人	ろうじん	the aged, old person.
話題	わだい	topic, subject.
数	かず	number, amount.
夫婦	ふうふ, めおと, みょうと	married couple, spouses, husband and wife, couple, pair., his and hers, pair of objects, one larger (for man), one smaller (for woman).
各々	それぞれ, おのおの	each, every, either, respectively, severally.
年齢	ねんれい	age, years.
我々	われわれ	we.
以前	いぜん	ago, since, before, previous.
一層	いっそう	much more, still more, all the more, more than ever., single layer (or storey, etc.).
印象	いんしょう	impression.
汚染	おせん	pollution, contamination.
何か	なにか, なんか	something.
価値	かち	value, worth, merit.
歌手	かしゅ	singer.
絵画	かいが	picture, painting.
確認	かくにん	confirmation, verification, validation, review, check, affirmation, identification.
学者	がくしゃ	scholar.
学習	がくしゅう	study, learning, tutorial.
額	がく	picture (framed)., amount or sum (of money).
株	かぶ	stock, share., stump., root, rootstock., strain (of bacteria, etc.)., tradeable rank, goodwill., one's forte.
感覚	かんかく	sense, sensation, feeling, intuition.
義務	ぎむ	duty, obligation, responsibility.
急速	きゅうそく	rapid (e.g. progress).
許可	きょか	permission, approval, authorization, license., to permit, to authorize.
供給	きょうきゅう	supply, provision.
緊張	きんちょう	tension, mental strain, nervousness.
近代	きんだい	present day, modern times.
金額	きんがく	amount of money.
空	から	emptiness, vacuum, blank.
訓練	くんれん	practice, practising, training.
劇	げき	drama, play., powerful drug.
建築	けんちく	construction, architecture (of buildings).
肩	かた	shoulder.
現金	げんきん	cash, ready money, money on hand, currency., mercenary, self-interested, calculating.
現象	げんしょう	phenomenon.
構成	こうせい	organization, organisation, configuration, composition.
合計	ごうけい	sum total, total amount.
差別	さべつ, しゃべつ, しゃべち	discrimination, distinction, differentiation.
最低	さいてい	least, lowest, worst., nasty, disgusting, horrible, yuck!.
材料	ざいりょう	ingredients, material.
参考	さんこう	reference, consultation.
残り	のこり	remnant, residue, remaining, left-over.
思想	しそう	thought, idea, ideology.
支配	しはい	rule, control, direction.
資源	しげん	resources.
資本	しほん	funds, capital.
失業	しつぎょう	unemployment.
実は	じつは	as a matter of fact, by the way, to tell you the truth, to be honest, frankly.
実行	じっこう	practice, practising, performance, execution (e.g. program) (programme), realization, realisation, implementation.
手術	しゅじゅつ	(surgical) operation, procedure.
手段	しゅだん	means, way, measure.
周囲	しゅうい	surroundings, environs., circumference.
就職	しゅうしょく	finding employment, getting a job.
集中	しゅうちゅう	concentration, convergence, centralization, integration, gathering together.
重大	じゅうだい	serious, important, significant, grave, weighty.
出版	しゅっぱん	publication.
章	しょう	chapter, section., medal.
場面	ばめん	scene, setting (e.g. of novel).
職業	しょくぎょう	occupation, business.
食品	しょくひん	commodity, foodstuff.
信用	しんよう	confidence, dependence, credit, faith, reliance, belief, credence, trust.
信頼	しんらい	reliance, trust, faith, confidence.
神	かみ, かむ, かん	god, deity, divinity, spirit, kami., incredible, fantastic.
制限	せいげん	restriction, restraint, limitation, limit.
勢い	いきおい	force, vigor, vigour, energy, spirit, life., influence, authority, power, might., impetus, momentum, course (of events)., naturally, necessarily.
性格	せいかく	character, personality, disposition, nature.
成功	せいこう	success, hit.
成績	せいせき	results, record, grades.
正午	しょうご	noon, mid-day.
生命	せいめい	life, existence.
請求	せいきゅう	claim, demand, charge, application, request, billing (for a service).
青年	せいねん	youth, young man.
跡	あと	trace, tracks, mark, sign., remains, ruins., scar.
設計	せっけい	plan, design, layout.
専攻	せんこう	major subject, special study.
選択	せんたく	selection, choice, option.
相当	そうとう	befitting, becoming, worthy of, proportionate, in keeping with, suitable., considerable, substantial., to be worthy of, to be proportionate to., to correspond to (in meaning, function, etc.), to be equivalent., extremely, considerably.
損害	そんがい	damage, injury, loss.
体育	たいいく	physical education, gymnastics, athletics.
代理	だいり	representation, agency, proxy, deputy, agent, attorney, substitute, alternate, acting (principal, etc.).
大臣	だいじん	cabinet minister.
大半	たいはん	majority, mostly, generally.
単位	たんい	unit, denomination., credit (in school).
誕生	たんじょう	birth, creation, formation.
地	ち	earth, ground, land, soil., place., territory., bottom (of a package, book, etc.)., earth (one of the five elements).
地位	ちい	(social) position, status.
地下	ちか	basement, cellar, underground place., underground, below ground., secret, under cover., underground (railway), subway, metro.
中学	ちゅうがく	middle school, junior high school.
中止	ちゅうし	suspension, stoppage, discontinuance, interruption.
注目	ちゅうもく	notice, attention, observation.
著者	ちょしゃ	author (usu. of a particular book, etc.), writer.
定期	ていき	fixed period, fixed term., regular, periodic, periodical., fixed-term commutation pass., fixed-term deposit., futures contracts.
抵抗	ていこう	resistance, opposition, standing up to., reluctance, repulsion, repugnance., resistance, drag, friction., electrical resistance., resistor.
提出	ていしゅつ	to present, to submit (e.g. a report or a thesis), to hand in, to file, to turn in., presentation, submission, filing.
徹底	てってい	thoroughness, completeness, consistency., thorough enforcement, seeing to it that a policy, etc. is carried out without exception.
鉄道	てつどう	railroad, railway, rail transport.
都	みやこ	capital, metropolis.
日常	にちじょう	ordinary, regular, everyday, usual.
農家	のうか	farmer, farm family.
俳優	はいゆう	actor, actress, player, performer.
犯罪	はんざい	crime.
範囲	はんい	extent, scope, sphere, range, span.
微妙	びみょう	delicate, subtle, sensitive., difficult, delicate (situation), complicated., doubtful, questionable, dicey, tricky.
物価	ぶっか	prices of commodities, prices (in general), cost-of-living.
物語	ものがたり	tale, story, legend.
物質	ぶっしつ	material, substance.
分析	ぶんせき	analysis.
雰囲気	ふんいき, ふいんき	atmosphere (e.g. musical), mood, ambience, ambiance.
変更	へんこう	change, modification, alteration, revision, amendment.
魅力	みりょく	charm, fascination, glamour, glamor, attraction, appeal.
模様	もよう	pattern, figure, design., state, condition., conjecture of the current situation, the way it seems., model, pattern, example., (after a noun) indicates that that noun seems likely (e.g. rain or storm).
余裕	よゆう	surplus, composure, margin, room, time, allowance, flexibility, scope, rope.
旅	たび	travel, trip, journey.
湾	わん	bay, gulf, inlet.
谷	たに	valley.
支払い	しはらい	payment.
戦い	たたかい	battle, fight, struggle, conflict.
演奏	えんそう	musical performance.
意外	いがい	unexpected, surprising.
移動	いどう	movement, transfer, migration, removal., mobile, moving, traveling, travelling, roving.
一体	いったい	...the heck (e.g. "what the heck?"), ...in the world (e.g. "why in the world?"), ...on earth (e.g. "who on earth?")., one object, one body, unity., one form, one style., one Buddhist image (or carving, etc.)., generally, in general.
一致	いっち	coincidence, agreement, union, match., conformity, consistency., cooperation.
化学	かがく, ばけがく	chemistry., chemical company (e.g. Acme Chemical Co.).
完成	かんせい	complete, completion., perfection, accomplishment.
完全	かんぜん	perfection, completeness.
感情	かんじょう	emotion, feeling, feelings, sentiment.
歓迎	かんげい	welcome, reception.
観客	かんきゃく	audience, spectator, spectators.
旗	はた	flag., pataka (banner).
既に	すでに, すんでに	already, too late.
記憶	きおく	memory, recollection, remembrance., storage.
貴重	きちょう	precious, valuable.
球	きゅう	sphere., counter for balls.
巨大	きょだい	huge, gigantic, enormous.
許す	ゆるす	to permit, to allow, to approve, to tolerate., to exempt (from fine), to excuse (from), to pardon, to forgive, to release, to let off., to confide in., to give up, to yield.
強力	きょうりょく	powerful, strong.
教科書	きょうかしょ	textbook, text book.
金属	きんぞく	metal.
刑事	けいじ	(police) detective., criminal matter.
計算	けいさん	calculation, reckoning, count., forecast.
穴	あな	hole., deficit, shortage, missing person (in a team, meeting, etc.)., vacancy, opening., flaw., profitable place (or item, etc.) not well known by others., upset victory (with a large payoff)., pit (of a theater).
限界	げんかい	limit, bound.
互い	たがい	mutual, reciprocal.
腰	こし, コシ	back, lower back, waist, hips, lumbar region., body (of hair, noodle, paper, etc.), resilience, spring.
骨	ほね	bone., frame., outline, core., backbone, spirit, fortitude., laborious, troublesome, difficult.
困難	こんなん	difficulty, distress.
財産	ざいさん	property, fortune, assets.
作曲	さっきょく	composition, setting (of music).
支出	ししゅつ	expenditure, expenses.
死亡	しぼう	death, mortality., to die, to pass away.
自動	じどう	automatic, self-motion., intransitive verb.
質	しつ	quality.
酒	さけ, ささ, き, くし, しゅ	alcohol, sake.
週	しゅう	week.
重視	じゅうし	importance, stress, serious consideration., to take something seriously, to attach importance, to stress.
瞬間	しゅんかん	moment, second, instant.
順調	じゅんちょう	favourable, favorable, doing well, OK, all right.
署名	しょめい	signature.
女優	じょゆう	actress.
松	まつ, マツ	pine tree (Pinus spp.)., highest (of a three-tier ranking system).
症状	しょうじょう	symptoms, condition.
笑い	わらい	laugh, laughter., smile., sneer., sex aids (e.g. dildos, pornographic books, erotic woodblock prints, etc.).
笑顔	えがお	smiling face, smile.
衝突	しょうとつ	collision, crash, running into., conflict, quarrel, clashing.
常に	つねに	always, constantly.
植物	しょくぶつ	plant, vegetation.
食料	しょくりょう	food.
心臓	しんぞう	heart., guts, nerve, cheek, gall, spine., central part.
心理	しんり	state of mind, mentality, psychology.
人類	じんるい	mankind, humanity.
世紀	せいき	century, era.
生物	せいぶつ	living things, creature., biology.
絶対	ぜったい	absolutely, unconditionally., absolute, unconditional, unmistakable., absoluteness.
操作	そうさ	operation, management, processing., manipulating to one's benefit., to operate., to manipulate, to fiddle (e.g. the books).
太陽	たいよう	sun, solar.
滞在	たいざい	stay, sojourn.
大戦	たいせん	great war, great battle.
単純	たんじゅん	simplicity, simple, uncomplicated.
知識	ちしき	knowledge, information.
注文	ちゅうもん	order, request.
貯金	ちょきん	putting money aside, savings, deposit (e.g. in a bank)., accumulated surplus of wins, wins in the bank.
底	そこ	bottom, sole.
適切	てきせつ	pertinent, appropriate, adequate, relevance.
適用	てきよう	applying (e.g. a technology), adoption.
鉄	てつ	iron (Fe)., strong and hard (as iron)., railway., railway enthusiast.
電子	でんし	electron., (esp. as a prefix) electronic, electronics.
土	つち, つし	earth, soil, dirt, clay, mud., the earth (historically, esp. as opposed to the heavens), the ground, the land., low-quality torinoko-gami (containing mud)., (period of) refraining from construction in the direction of the god of the earth (in On'youdou).
土曜	どよう	Saturday.
同一	どういつ	identity, sameness, similarity, equality, fairness.
日中	にっちゅう, ひなか	daytime, during the day., Sino-Japanese.
入場	にゅうじょう	entrance, admission, entering.
農民	のうみん	farmers, peasants.
波	なみ	wave.
博物館	はくぶつかん	museum.
爆発	ばくはつ	explosion, detonation, eruption.
発見	はっけん	discovery, detection, finding.
秘密	ひみつ	secret, secrecy, confidentiality, privacy., secret, mystery., esoteric teachings.
飛行	ひこう	aviation, flight, flying., to fly, to take a flight.
表面	ひょうめん	surface, outside, face, appearance.
不正	ふせい	injustice, unfairness, iniquity, impropriety, irregularity, dishonesty, illegality, fraud.
婦人	ふじん	woman, lady, adult female.
風景	ふうけい	scenery, scene, landscape, view, sight., scene (e.g. of a crime).
別に	べつに	(not) particularly, nothing., separately, apart.
暮らし	くらし	life, living, livelihood, life circumstances.
末	すえ	tip, top., end, close (e.g. close of the month)., youngest child., descendants, offspring, posterity., future., finally., trivialities.
未来	みらい	the future (usually distant)., future tense., the world to come.
名人	めいじん	master, expert.
命	いのち	life, life force., lifetime, lifespan., most important thing, foundation, core.
命令	めいれい	order, command, decree, directive., (software) instruction, statement.
野	の, や, ぬ	plain, field., hidden (structural) member., wild., lacking a political post.
役	やく	use, service, role., post, position., scoring combination (e.g. in mahjong, card games, etc.), hand.
油	あぶら	oil.
友	とも	friend, companion, comrade, pal.
予防	よぼう	prevention, precaution, protection against.
曜日	ようび	day of the week.
要素	ようそ	component, factor, item (e.g. in list)., element (e.g. in array), member (e.g. data structure).
涙	なみだ, なだ, なんだ	tear, tears, lachrymal secretion., sympathy.
列車	れっしゃ	train (ordinary).
論文	ろんぶん	thesis, essay, treatise, paper, article.
一家	いっか, いっけ	a house, a home, a family, a household, one's family, one's folks, a style.
少女	しょうじょ, おとめ	little girl, maiden, young lady, female usually between 7 and 18 years old.
乗客	じょうきゃく, じょうかく	passenger.
直	じき	soon, in a moment, before long, shortly., nearby, close., direct., spot transaction, cash transaction.
位置	いち	place, situation, position, location.
丘	おか	hill, height, knoll, rising ground., bonus points awarded to the winner at the end of a game (mahjong).
影	かげ	shadow, silhouette, figure, shape., reflection, image., ominous sign., light (stars, moon)., trace, shadow (of one's former self).
桜	さくら, サクラ	cherry tree, cherry blossom., decoy, fake buyer, shill., hired applauder., horse meat.
年寄り	としより	old people, the aged., trustee of the Japan Sumo Association, retired high-ranking wrestler who is licensed to coach and receives retirement pay., senior statesman (of the Tokugawa shogunate)., important local official (under the Tokugawa Shogunate).
残す	のこす	to leave (behind, over), to bequeath, to save, to reserve.
郵便	ゆうびん	mail service, postal service, mail, post., mail, postal matter, postal items.
有利	ゆうり	advantageous, better, profitable, lucrative.
喜び	よろこび	joy, delight, rapture, pleasure, gratification, rejoicing, congratulations, felicitations.
勝ち	かち	win, victory.
異常	いじょう	strangeness, abnormality, disorder.
一種	いっしゅ, ひとくさ	species, kind, variety.
引退	いんたい	retire.
演技	えんぎ	acting, performance.
縁	ふち	rim, brim, edge, brink.
何とか	なんとか	something, something or other, so-and-so., somehow, anyhow, one way or another.
火災	かさい	conflagration, fire.
画家	がか	painter, artist.
会計	かいけい	account, finance, accountant, treasurer, paymaster, reckoning, bill.
解釈	かいしゃく	explanation, interpretation.
汗	あせ	sweat, perspiration., moisture, condensation.
願い	ねがい	desire, wish, request, prayer, petition, application.
気温	きおん	atmospheric temperature.
休暇	きゅうか	holiday, day off, furlough, absence (from work).
急激	きゅうげき	sudden, precipitous, radical.
強盗	ごうとう	robber, mugger., robbery, burglary.
琴	こと, そう	koto (13-stringed Japanese zither)., zheng (Chinese zither), guzheng.
型	かた, がた	model, type (e.g. of machine, goods, etc.)., type, style, pattern., mold (mould), template, model., kata (standard form of a movement, posture, etc. in martial arts, sport, etc.)., form (i.e. customary procedure)., size (i.e. clothing, shoes)., (taxonomical) form.
見事	みごと	splendid, magnificent, beautiful, admirable., praiseworthy act, feat, commendable deed., utter (esp. defeat), total, complete.
限る	かぎる	to restrict, to limit, to confine., to be restricted to, to be limited to, to be confined to.
呼吸	こきゅう	breath, respiration., knack, trick, secret (of doing something).
合格	ごうかく	success, passing (e.g. exam), eligibility.
根	ね	root (of a plant)., root (of a tooth, hair, etc.), center (of a pimple, etc.)., root root (of all evil, etc.), source, origin, cause, basis., one's true nature., (fishing) reef.
罪	つみ	crime, fault, indiscretion, sin.
示す	しめす	to (take out and) show, to demonstrate, to tell, to exemplify, to make apparent., to point out (finger, clock hand, needle, etc.)., to indicate, to show, to represent, to signify, to display.
芝居	しばい	play, drama.
借金	しゃっきん	debt, loan, liabilities.
種類	しゅるい	variety, kind, type, category., counter for different sorts of things.
書類	しょるい	documents, official papers.
尚	なお	furthermore, still, yet, more, still more, in addition, greater, further.
常識	じょうしき	common sense, good sense, common knowledge, general knowledge, common practice, accepted practice, social etiquette.
審判	しんぱん, しんばん	refereeing, trial, judgement, judgment, umpire, referee.
慎重	しんちょう	careful, cautious, prudent, discreet, deliberate.
神経	しんけい	nerve., nerves, sensitivity.
人工	じんこう	artificial, man-made, human work, human skill, artificiality.
人種	じんしゅ	race (of people).
整理	せいり	sorting, arrangement, organization, putting in order, adjustment, regulation., liquidation, settlement, consolidation, clearance (e.g. debt), paying off., retrenchment, curtailment, cutting down, disposal.
税金	ぜいきん	tax, duty.
善	ぜん	good, goodness, right, virtue.
騒ぎ	さわぎ	uproar, disturbance.
贈る	おくる	to give (as a gift), to present., to confer, to bestow, to award.
息	いき, おき	breath, breathing., tone, mood.
孫	まご	grandchild.
損	そん	loss, disadvantage.
代金	だいきん	price, payment, cost, charge, the money, the bill.
大気	たいき	atmosphere.
大陸	たいりく	continent.
奪う	うばう	to snatch away, to dispossess, to steal.
調子	ちょうし	tune, tone, key, pitch, time, rhythm., vein, mood, way, manner, style, knack., condition, state of health., impetus, spur of the moment, strain., trend.
直ちに	ただちに	at once, immediately, directly, in person, automatically.
追う	おう	to chase, to run after, to pursue., to follow (i.e. a set order, a trend)., to drive out, to oust, to expel., to drive (i.e. a herd)., (in passive voice) to be pressed (for time, etc.).
哲学	てつがく	philosophy.
得意	とくい	triumph, prosperity., pride., one's strong point, one's forte, one's specialty., frequent customer (client, etc.).
独特	どくとく	peculiarity, uniqueness, characteristic.
読書	どくしょ, とくしょ	reading.
日曜	にちよう	Sunday.
能	のう	talent, gift, function., noh (theatre).
犯人	はんにん	offender, criminal.
否定	ひてい	negation, denial, repudiation., NOT operation.
比較	ひかく	comparison.
必ずしも	かならずしも	(not) always, (not) necessarily, (not) all, (not) entirely.
評判	ひょうばん	fame, reputation, popularity., rumour (rumor), talk.
負け	まけ	defeat, loss, losing (a game).
腹	はら	abdomen, belly, stomach., womb., one's mind, one's real intentions, one's true motive., courage, nerve, willpower., generosity, magnanimity., feelings, emotions., wide middle part, bulging part., inside, interior, inner part., anti-node., counter for hard roe., counter for containers with bulging middles (pots, vases, etc.).
分ける	わける	to divide (into), to split (into), to part, to separate, to divide up, to classify, to sort out, to divide out., to share, to distribute, to deal out, to dish out., to distinguish, to discriminate, to differentiate (between)., to break up (a fight), to mediate., to call a draw, to tie., to push one's way through (a crowd)., to sell.
文明	ぶんめい	civilization, civilisation, culture., Bummei era (1469.4.28-1487.7.20).
保存	ほぞん	preservation, conservation, storage, saving (e.g. to disk), maintenance.
宝	たから	treasure.
豊富	ほうふ	abundance, wealth, plenty, bounty.
棒	ぼう	pole, rod, stick.
満足	まんぞく	satisfaction, contentment, complacency., sufficient, enough, adequate, proper.
免許	めんきょ	license, permit, licence, certificate.
優秀	ゆうしゅう	superiority, excellence.
容易	ようい	easy, simple, plain.
来	らい	next (year, etc.)., since (last month, etc.).
理想	りそう	ideal, dream.
離れる	はなれる	to be separated, to be apart, to be distant., to leave, to go away., to leave (a job, etc.), to quit, to give up., to lose connection with, to drift away from.
陸	りく, おか	land, shore.
留学	りゅうがく	studying abroad (usu. at university level).
輪	わ	ring, circle, loop., hoop., wheel., circle (e.g. of friends).
冷静	れいせい	calm, composure, coolness, serenity.
礼	れい	thanks, gratitude., manners, etiquette., bow., reward, gift., ceremony, ritual.
論争	ろんそう	controversy, dispute.
化粧	けしょう, けわい, けそう	make-up, makeup, cosmetics.
傷	きず, キズ	wound, injury, cut, gash, bruise, scratch, scrape, scar., chip, crack, scratch, nick., flaw, defect, weakness, weak point., stain (on one's reputation), disgrace, dishonor, dishonour., (emotional) hurt, hurt feelings.
他人	たにん, ひと, あだびと	another person, other people, others., unrelated person (i.e. not related by blood)., outsider, stranger.
端	はし, はじ, はな	end (e.g. of street), tip, point, edge, margin., beginning, start, first., odds and ends, scrap, odd bit, least.
敵	てき	opponent, rival, adversary., menace, danger, threat, enemy.
刺激	しげき	stimulus, impetus, incentive, encouragement, motivation, provocation, excitement, thrill.
必死	ひっし	frantic, desperate., inevitable death., brinkmate (inevitable checkmate) (shogi).
昼食	ちゅうしょく, ちゅうじき, ひるげ	lunch, midday meal., food served at a tea party (tea ceremony).
依頼	いらい	request, commission, dispatch, despatch., dependence, trust.
一瞬	いっしゅん	moment, instant.
印刷	いんさつ	printing.
栄養	えいよう	nutrition, nourishment.
延期	えんき	postponement, adjournment.
応じる	おうじる	to respond, to satisfy, to accept, to comply with, to apply for.
屋根	やね	roof.
温暖	おんだん	warmth.
温度	おんど	temperature.
家事	かじ	housework, domestic chores., family affairs, household matters.
活用	かつよう	practical use, application., conjugation, declension, inflection.
感動	かんどう	being deeply moved emotionally, excitement, passion, deep emotion, impression.
缶	かん	can, tin.
給料	きゅうりょう	salary, wages.
牛	うし, ぎゅう, ウシ	cattle (Bos taurus), cow, ox, oxen., beef., Chinese "Ox" constellation (one of the 28 mansions).
恐怖	きょうふ, くふ	fear, dread, dismay, terror, horror, scare, panic.
玉	たま	ball, sphere, globe, orb., bead (of sweat, dew, etc.), drop, droplet., ball (in sports)., pile (of noodles, etc.)., bullet., bulb (i.e. a light bulb)., lens (of glasses, etc.)., bead (of an abacus)., ball (i.e. a testicle)., gem, jewel (esp. spherical; sometimes used figuratively), pearl., female entertainer (e.g. a geisha)., person (when commenting on their nature), character., item, funds or person used as part of a plot., egg., coin., precious, beautiful, excellent.
金銭	きんせん	money, cash.
苦労	くろう	troubles, hardships.
軍隊	ぐんたい	armed forces, military, troops.
警告	けいこく	warning, advice.
欠陥	けっかん	defect, fault, deficiency, deformity., shortage, gap.
言語	げんご, ごんご, げんきょ	language.
光景	こうけい	scene, spectacle, sight, view.
高速	こうそく	high speed, high gear., highway, freeway, expressway, motorway.
左右	さゆう, そう, さう	left and right., influence, control, domination.
際	さい	on the occasion of, circumstances, juncture.
殺す	ころす	to kill.
詩人	しじん	poet.
自殺	じさつ	suicide.
失う	うしなう	to lose, to part with.
主に	おもに	mainly, primarily.
終える	おえる	to finish., to graduate.
宿泊	しゅくはく	lodging.
出来事	できごと, できこと	incident, affair, happening, event.
順	じゅん, ずん	order, turn., obedient, docile, submissive, meek.
助手	じょしゅ, すけて	helper, helpmeet, assistant, tutor.
女王	じょおう	queen.
商売	しょうばい	trade, business, commerce, transaction, occupation.
消防	しょうぼう	fire fighting, fire department.
証明	しょうめい	proof, verification, certification.
賞	しょう	prize, award.
信号	しんごう	signal, signalling, signaling., traffic light, traffic signal.
身長	しんちょう	height (of body), stature.
進学	しんがく	entering a higher-level school, esp. going on to university.
世の中	よのなか	society, the world, the times.
世間	せけん	world, society.
先日	せんじつ	the other day, a few days ago.
泉	いずみ	spring, fountain.
前進	ぜんしん	advance, drive, progress.
騒音	そうおん	noise.
大いに	おおいに	very, much, greatly, a lot of.
単なる	たんなる	mere, simple, sheer.
単に	たんに	simply, merely, only, solely.
知恵	ちえ	wisdom, wit, sagacity, sense, intelligence., prajna (insight leading to enlightenment).
茶	ちゃ	tea., tea plant (Camellia sinensis)., tea preparation, making tea., brown.
通過	つうか	passage through (e.g. train skipping a station), transit., passing (e.g. exam, bill through parliament).
登山	とざん	mountain climbing.
都会	とかい	city., Tokyo Metropolitan Assembly.
働き	はたらき	work, labor, labour., achievement, performance, ability, talent., salary, income, earnings., action, activity, workings, function, operation, movement, motion., conjugation, inflection.
熱帯	ねったい	tropics.
拍手	はくしゅ	clapping hands, applause.
肌	はだ, はだえ	skin., body (in the context of intimate bodily contact)., surface, grain (e.g. of wood), texture., disposition, temperament, character, type.
飯	めし	cooked rice., meal, food., one's livelihood.
悲劇	ひげき	tragedy, disaster.
付き合い	つきあい	association, socializing, socialising, fellowship.
布	ぬの, ふ, にの, にぬ	cloth., bujian (spade-shaped bronze coin of ancient China).
墓	はか	gravesite, tomb.
暮れ	くれ	sunset, sundown, nightfall, dusk., end, close., year-end, end of the year.
本物	ほんもの	genuine article, real thing, real deal.
迷惑	めいわく, べいこく	trouble, bother, annoyance.
離婚	りこん	divorce.
恋	こい	(romantic) love.
一生	いっしょう	whole life, a lifetime, all through life, one existence, a generation, an age, the whole world, the era., (the only, the greatest, etc.) of one's life.
冠	かんむり, かん, かむり, かんぶり	cap (esp. a traditional cap worn with sokutai or ikan clothing), crown, diadem, coronet., top kanji radical., first verse of a haikai, etc.., best, peerless, first.
思い出	おもいで	memories, recollections, reminiscence.
香り	かおり	aroma, fragrance, scent, smell.
砂漠	さばく	desert.
囲む	かこむ, かごむ	to surround, to encircle, to enclose, to fence, to wall in., to besiege, to lay siege to., to play (go, shogi, etc.).
印	しるし	mark, sign., symbol, emblem., badge, crest, flag., evidence, proof., token (of gratitude, affection, etc.).
煙	けむり, けぶり, けむ, けぶ	smoke, fumes.
奥	おく	interior, inner part, inside.
可	か	passable, acceptable, tolerable, fair.
家賃	やちん	rent.
覚悟	かくご	resolution, resignation, readiness, preparedness.
間違い	まちがい	mistake, error, blunder., accident, mishap, trouble., improper conduct (e.g. between man and woman), indiscretion.
岸	きし	bank, coast, shore.
技	わざ, ぎ	technique, art, skill.
共に	ともに	together, jointly., at the same time, with, as ..., including, along with., both.
経由	けいゆ, けいゆう	through, by way of, via., to go via, to go by way of.
誇り	ほこり	pride, boast.
誤り	あやまり	error, mistake, slip, bug.
誤解	ごかい	misunderstanding.
収穫	しゅうかく	harvest, crop, ingathering., fruits (of one's labors), results.
修理	しゅうり, しゅり, すり	repairing, mending, servicing.
宿	やど	lodging, inn, hotel., house, home, dwelling., home of a servant's parents (or guarantor, etc.).
詳しい	くわしい	detailed, full, accurate., knowing very well, well-acquainted, well-informed.
新鮮	しんせん	fresh.
進歩	しんぽ	progress, advance, improvement, development.
睡眠	すいみん	sleep.
成人	せいじん	adult., to grow up, to mature., to come of age.
正直	しょうじき	honesty, integrity, frankness., honestly, frankly.
想像	そうぞう	imagination, guess.
巣	す	nest, rookery, breeding place, hive., den., haunt., (spider's) web.
速度	そくど	speed, velocity, rate.
多少	たしょう	more or less, somewhat, a little, some.
仲	なか	relation, relationship.
天然	てんねん	nature, spontaneity., natural airhead.
塔	とう	tower, steeple, spire., stupa, pagoda, dagoba.
突然	とつぜん	abrupt, sudden, unexpected, all at once.
年代	ねんだい	age, era, period, date.
梅	うめ, むめ, ウメ	Japanese apricot (Prunus mume), Chinese plum., lowest (of a three-tier ranking system).
半ば	なかば	middle, half, semi, halfway, partly.
疲れ	つかれ	tiredness, fatigue.
瓶	びん	bottle, jar, decanter, flagon, phial, vial.
不自由	ふじゆう	discomfort, inconvenience., poverty, want, destitution., disability, impairment (physical, mental, etc.).
普段	ふだん	usual, habitual, ordinary, everyday, always.
平等	びょうどう	equality, impartiality, evenness.
柄	がら	pattern, design., body build, figure, physique., essential qualities, character, nature., appropriate to, fitting of, suitable for.
弁当	べんとう	bento, Japanese box lunch.
堀	ほり	moat, fosse., canal, ditch.
妙	みょう	strange, unusual., (something) superb, (something) excellent.
問い	とい	question, query.
勇気	ゆうき	courage, bravery, valour, valor, nerve, boldness.
予報	よほう	forecast, prediction.
容器	ようき	container, vessel.
恋人	こいびと	lover, sweetheart.
一言	ひとこと, いちげん, いちごん	single word, a few words, brief comment.
値	あたい, ね	price, cost., value, worth, merit., value, count, number., variable (computer programming, programing).
方々	かたがた	they (of people), gentlemen (of the ...)., you (usu. plural)., various.
何でも	なんでも	any, whatever one likes, by all means, anything, everything., I am told, I understand, they say, I hear.
始まり	はじまり	origin, beginning.
稲	いね	rice-plant.
王子	おうじ	prince.
下り	くだり	down-train (going away from Tokyo)., down-slope, downward going.
家具	かぐ	furniture.
課	か	lesson., section (in an organization), division, department., counter for lessons and chapters (of a book).
芽	め	sprout.
感謝	かんしゃ	thanks, gratitude.
観察	かんさつ	observation, survey.
岩	いわ	rock, boulder., crag, cliff., anchor.
気候	きこう	climate.
気味	きみ, きび	sensation, feeling., tendency, propensity.
鬼	おに, き	ogre, demon., spirit of a deceased person., ogre-like person (i.e. fierce, relentless, merciless, etc.)., it (i.e. in a game of tag)., Chinese "ghost" constellation (one of the 28 mansions)., very, extremely, super-.
休憩	きゅうけい	rest, break, recess, intermission.
境	さかい, きょう	border, boundary., turning point, watershed., area, region, spot, space, environment., psychological state, mental state., cognitive object, something perceptible by the sense organs or mind.
禁煙	きんえん	abstaining from smoking, quitting smoking., No Smoking!, Smoking Prohibited!.
筋肉	きんにく	muscle, sinew.
金曜	きんよう	Friday.
苦手	にがて	poor (at), weak (in), not very good (at)., dislike (of).
結ぶ	むすぶ	to tie, to bind, to link., to bear (fruit)., to close (e.g. deal), to confirm, to conclude., to connect (two distant places)., to close tightly, to purse (e.g. lips)., to unite (with), to ally, to join hands.
見送り	みおくり	seeing one off, farewell, escort.
好み	このみ	liking, taste, choice.
豪華	ごうか	wonderful, gorgeous, splendor, splendour, pomp, extravagance.
国語	こくご	national language., Japanese language (often as a school subject in Japan)., native Japanese words (as opposed to loanwords).
座席	ざせき	seat.
才能	さいのう	talent, ability.
酸素	さんそ	oxygen (O).
支払う	しはらう	to pay.
祝い	いわい, ゆわい	congratulation, congratulations, celebration, festival, congratulatory gift.
冗談	じょうだん, ぎだん, げだん	jest, joke, funny story.
針	はり, ち	needle, pin., hook., stinger, thorn., hand (e.g. clock, etc.), pointer., staple (for a stapler)., needlework, sewing., malice., counter for stitches.
図	ず	drawing, picture, diagram, figure, illustration, chart, graph., sight, scene.
尊重	そんちょう	respect, esteem, regard.
袋	ふくろ	bag, sack, pouch., skin of an orange (and other like fruits)., dead end., plot of land surrounded by water.
大部分	だいぶぶん	most part, greater part, majority.
通行	つうこう	passage, passing., common usage.
天候	てんこう	weather.
到着	とうちゃく	arrival.
独身	どくしん	bachelorhood, single, unmarried, celibate.
読み	よみ	reading.
板	いた	board, plank., sheet (of metal), plate (of glass), pane, slab., cutting board, chopping board., chef (esp. of high-end Japanese cuisine), cook., stage (i.e. at a theatre).
皮	かわ	skin, hide, pelt, fur., rind, peel, husk, bark., shell, sheath, wrapping., mask (hiding one's true nature), seeming.
氷	こおり	ice., shaved ice (usually served with flavored simple syrup).
不幸	ふこう	unhappiness, sorrow, misfortune, disaster, accident, death.
不利	ふり	disadvantage, handicap, unfavorable, unfavourable, drawback.
文句	もんく	complaint, grumbling, objection., phrase, words, expression.
別れ	わかれ	parting, separation, farewell, (lateral) branch, fork, offshoot, division, section.
抱える	かかえる	to hold or carry under or in the arms., to have (esp. problems, debts, etc.)., to employ, to engage, to hire.
冒険	ぼうけん	risk, venture, adventure.
面倒	めんどう	trouble, difficulty, care, attention.
流す	ながす	to drain, to pour, to spill, to shed (blood, tears)., to wash away., to distribute (e.g. electricity over wires, music over a PA system, etc.), to circulate, to broadcast, to beam., to cruise (e.g. taxi)., to float, to set adrift., to call off (a meeting, etc.).
列	れつ	queue, line, row, column, sequence, string, train.
姉妹	しまい, きょうだい	sisters.
様々	さまざま	varied, various.
向かい	むかい	facing, opposite, across the street, other side.
愛情	あいじょう	love, affection.
偉大	いだい	greatness.
運	うん	fortune, luck.
嫁	よめ	wife, bride., (one's) daughter-in-law.
感じる	かんじる	to feel, to sense, to experience.
奇妙	きみょう	strange, queer, curious.
救助	きゅうじょ	relief, aid, rescue.
局	きょく	bureau, department., office (e.g. post, telephone), broadcasting station (e.g. television, radio), channel, exchange., affair, situation., game (of go, shogi, etc.).
金庫	きんこ	safe, strongbox, cashbox, vault, strongroom., depository, cash office, treasury, provider of funds.
繰り返す	くりかえす	to repeat, to do something over again.
語る	かたる	to talk about, to speak of, to tell, to narrate., to recite, to chant., to indicate, to show.
時刻	じこく	instant, time, moment.
守る	まもる	to protect, to guard, to defend., to keep (i.e. a promise), to abide (by the rules), to observe, to obey, to follow.
渋滞	じゅうたい	congestion (e.g. traffic), delay, stagnation.
小屋	こや	hut, cabin, shed, (animal) pen.
信仰	しんこう	(religious) faith, belief, creed.
図書	としょ	books.
盛り	さかり	peak (e.g. of cherry blossom season), height (e.g. of summer)., prime (of one's life), one's best days., rutting, being in heat.
石炭	せきたん	coal.
釣り	つり	fishing, angling., change (e.g. for a purchase)., trolling, writing false posts online.
典型	てんけい	type, pattern, model, epitome, exemplar, archetypal, representative.
納得	なっとく	consent, assent, understanding, agreement, comprehension, grasp.
破産	はさん	bankruptcy, insolvency.
批評	ひひょう	criticism, review, commentary.
革	かわ	leather.
筆	ふで	writing brush.
服装	ふくそう	garments, attire.
物理	ぶつり	physics, law of nature.
味方	みかた	friend, ally, supporter.
無事	ぶじ	safety, peace, quietness.
黙る	だまる	to be silent.
裸	はだか	naked, nude, bare.
幸せ	しあわせ, しやわせ	happiness, good fortune, luck, blessing.
集まり	あつまり	gathering, meeting, assembly, collection, attendance.
続き	つづき	sequel, continuation, (also suffix) continuation (in time and space), second series, succession, spell.
悪魔	あくま	devil, demon, fiend, Satan, evil spirit.
永遠	えいえん	eternity, perpetuity, immortality, permanence.
横断	おうだん	crossing., transverse.
穏やか	おだやか	calm, gentle, quiet.
外出	がいしゅつ, そとで	outing, trip, going out.
学問	がくもん	scholarship, study, learning.
感心	かんしん	admiration, Well done!.
帰宅	きたく	returning home.
技師	ぎし	engineer, technician.
逆	ぎゃく	reverse, opposite., converse (of a hypothesis, etc.).
吸収	きゅうしゅう	absorption, suction, attraction.
区別	くべつ	distinction, differentiation, classification.
欠席	けっせき	absence, non-attendance.
月曜	げつよう	Monday.
後者	こうしゃ	the latter.
語学	ごがく	language study.
公平	こうへい	fairness, impartial, justice.
皿	さら	plate, dish, platter, disc., serving, helping, course., kanji radical 108 (at the bottom).
自慢	じまん	pride, boast.
手間	てま	time, labour, labor.
城	しろ	castle.
食卓	しょくたく	dining table.
相続	そうぞく	succession, inheritance.
断る	ことわる	to refuse, to reject, to dismiss, to turn down, to decline., to inform, to give notice, to tell in advance., to ask leave, to excuse oneself (from).
通学	つうがく	commuting to school, school commute.
泥	どろ	mud, slush, (wet) dirt, mire., thief.
当てる	あてる	to hit., to expose., to apply (e.g. patch), to put on, to put against, to hold on, to hold against., to allot, to call on someone (e.g. in class)., to guess (an answer)., to make a hit (e.g. in a lottery).
毒	どく	poison, toxicant., harm, evil influence., ill will, spite, malice., abusive language.
望み	のぞみ	wish, desire, hope., prospect, expectation, (one's) hopes.
友情	ゆうじょう	friendship, fellowship, camaraderie.
誘う	さそう, いざなう	to invite, to ask, to call (for)., to tempt, to lure, to induce.
翼	つばさ, よく	wing., Chinese "Wings" constellation (one of the 28 mansions).
係	かかり	charge, duty, person in charge, official, clerk., connection, linking.
愛する	あいする	to love.
握手	あくしゅ	handshake.
鋭い	するどい	sharp (blade), pointed., sharp (pain), stabbing, cutting (remark), stinging, pointed (question or look), screeching (noise)., perceptive, keen, quick (mind), astute, shrewd, discerning., nimble, agile, quick.
炎	ほのお, ほむら	flame, blaze., flames (of intense emotion, e.g. love, jealousy, anger), passion.
勘定	かんじょう	calculation, counting, consideration, reckoning, settlement of an account, allowance.
苦痛	くつう	pain, agony, bitterness.
交際	こうさい	company, friendship, association, society, acquaintance.
幸福	こうふく	happiness, blessedness, joy, well-being.
高価	こうか	high price.
穀物	こくもつ	grain, cereal, corn.
婚約	こんやく	engagement, betrothal.
混雑	こんざつ	congestion, crush, crowding, jam., confusion, disorder.
失望	しつぼう	disappointment, despair.
順番	じゅんばん	turn (in line), order of things, sequential order.
食物	しょくもつ	food, foodstuff.
舌	した	tongue., tongue-like object, clapper (of a bell), talon (of a lock).
中古	ちゅうこ, ちゅうぶる	used, second-hand, old., Middle Ages.
徹夜	てつや	all night, all-night vigil, sleepless night.
土産	みやげ	present, souvenir.
頭痛	ずつう	headache.
鍋	なべ	saucepan, pot., stew, hot pot.
日光	にっこう	sunlight.
配達	はいたつ	delivery, distribution.
発達	はったつ	development, growth.
美人	びじん	beautiful person (woman).
宝石	ほうせき	gem, jewel, precious stone.
霧	きり	fog, mist., spray.
木曜	もくよう	Thursday.
話し合う	はなしあう	to discuss, to talk together.
永久	えいきゅう, とこしえ, とわ	eternity, perpetuity, immortality., Eikyuu era (1113.7.13-1118.4.3).
雷	かみなり, いかずち, いかづち, らい	lightning, thunder, thunderbolt., god of thunder, god of lightning., anger, fit of anger.
覆う	おおう	to cover, to hide, to conceal, to wrap, to disguise.
乗せる	のせる	to place on (something)., to give (someone) a ride, to give a lift, to pick up, to help on board., to load (luggage), to carry, to take on board., to send out (on the airwaves, etc.)., to deceive, to take for a ride., to (sing) along with (musical accompaniment)., to let (someone) take part., to excite (someone)., to publish (an article), to run (an ad).
見舞い	みまい	visiting ill or distressed people, writing get-well letters., get-well gifts, get-well letters., expression of sympathy, expression of concern, enquiry, inquiry.
隠す	かくす	to hide, to conceal.
活気	かっき	energy, liveliness.
勘	かん	perception, intuition, the sixth sense.
居間	いま	living room (western style).
叫ぶ	さけぶ	to shout, to cry, to scream, to shriek, to yell, to exclaim., to clamor (for or against), to clamour (for or against).
句	く	section (i.e. of text), sentence, passage, paragraph., phrase., verse (of 5 or 7 mora in Japanese poetry; of 4, 5, or 7 characters in Chinese poetry)., haiku, first 17 morae of a renga, etc.., maxim, saying, idiom, expression.
敬意	けいい	respect, honour, honor.
欠点	けってん	fault, defect, flaw, weak point, weakness, shortcoming, drawback., failure (in an examination), failing grade.
考慮	こうりょ	consideration, taking into account.
克服	こくふく	conquest (problem, disease, handicap, etc. e.g. poverty, illness), overcoming, bringing under control, subjugation, victory over.
骨折	こっせつ	bone fracture.
手伝い	てつだい	helper, assistant., help.
受け取る	うけとる	to receive, to get, to accept., to take, to interpret, to understand.
奨学金	しょうがくきん	scholarship, stipend, bursary., student loan.
小麦	こむぎ	wheat.
清潔	せいけつ	clean, hygienic, sanitary., pure, virtuous, immaculate.
生地	きじ	cloth, fabric, material, texture., one's true character., unglazed pottery., uncooked dough, batter.
節約	せつやく	economising, saving.
注	ちゅう	annotation, explanatory note, comment.
駐車	ちゅうしゃ	parking (e.g. car).
笛	ふえ, ちゃく	flute, fife, pipe, recorder, flageolet, shakuhachi, clarinet., whistle.
刀	かたな, とう	(single-edged) sword, katana.
飛び出す	とびだす	to jump out, to rush out, to fly out., to appear (suddenly)., to protrude, to project., to butt in.
歩道	ほどう	footpath, walkway, sidewalk.
望む	のぞむ	to desire., to wish for, to expect., to see, to command (a view of).
要するに	ようするに	in a word, after all, the point is ..., in short ..., to put simply, the long and short of it is that .....
嵐	あらし	storm, tempest., difficulty, trouble.
扱う	あつかう	to handle, to deal with, to treat.
移す	うつす	to change, to swap, to substitute, to transfer., to change the object of one's interest or focus., to spend or take time., to infect., to permeate something with the smell or colour of something., to move on to the next or different stage of (a plan, etc.).
衣服	いふく	clothes.
楽	らく	comfort, ease., raku pottery.
掲示	けいじ	notice, bulletin, post, posting, placard.
迎え	むかえ	meeting, greeting, welcome.
食欲	しょくよく	appetite (for food).
真っ赤	まっか	bright red, deep red, flushed (of face)., downright (e.g. lie), complete, utter.
診察	しんさつ	medical examination.
生き物	いきもの	living thing, animal.
前者	ぜんしゃ	the former.
双子	ふたご, そうし	twins, twin.
頂上	ちょうじょう	top, summit, peak.
不思議	ふしぎ	wonder, miracle, strange, mystery, marvel, curiosity.
物事	ものごと	things, everything.
粉	こな, こ	flour, meal, powder.
塀	へい	wall., fence.
便り	たより	news, tidings, information, correspondence, letter.
泡	あわ, あぶく	bubble, foam, froth, head on beer.
綿	わた	cotton plant (Gossypium spp.)., batting, wadding, padding.
毛布	もうふ	blanket.
夜中	よなか	midnight, dead of night.
商人	しょうにん, あきんど, あきうど, あきゅうど, あきびと	trader, shopkeeper, merchant.
空き	あき	space, room, emptiness, gap., opening, vacancy, empty seat., free time, time to spare., disuse, unused thing.
意志	いし	will, volition, intention, intent, determination.
猿	さる, サル	monkey (esp. the Japanese macaque, Macaca fuscata), ape, non-human primate., sly person., idiot, hick., sliding wooden bolt (for holding a door or window shut)., clasp used to control the height of a pot-hook.
我慢	がまん	patience, endurance, perseverance, tolerance, self-control, self-denial.
外す	はずす	to unfasten, to undo., to remove, to take off, to deinstall., to leave, to step out, to slip away., to miss (a target).
疑う	うたがう	to doubt, to distrust, to be suspicious of, to suspect.
偶然	ぐうぜん	(by) chance, unexpectedly, suddenly, accident, fortuity, by coincidence.
芝生	しばふ	lawn.
従って	したがって	therefore, consequently, accordingly.
書物	しょもつ	books.
親友	しんゆう	close friend, bosom (old, intimate) friend, buddy, crony, chum.
体温	たいおん	temperature, body temperature (human, animal).
題	だい	title, subject, theme, topic., problem (on a test), question., counter for questions (on a test).
単語	たんご	word, vocabulary, (usually) single-character word.
道徳	どうとく	morals.
謎	なぞ	riddle, puzzle, enigma, mystery., enigmatic, mysterious.
破る	やぶる	to tear, to violate, to defeat, to smash, to destroy, to break (e.g. password).
無視	むし	disregarding, ignoring.
夜明け	よあけ	dawn, daybreak.
王様	おうさま	king.
回す	まわす	to turn, to rotate, to gyrate., to circulate, to send around., to surround., to put something to a new use (e.g. leftovers)., (after the -masu stem of a verb) ... around (i.e. to chase someone around)., to dial (e.g. telephone number)., to invest., to gang-rape.
完了	かんりょう	completion, conclusion., perfect (tense, form, aspect).
記入	きにゅう	entry, filling in of forms.
起こる	おこる	to occur, to happen.
救う	すくう	to rescue from, to help out of, to save.
恐らく	おそらく	perhaps, likely, probably, I dare say.
幸い	さいわい	happiness, blessedness, luck, fortune, felicity., luckily, fortunately.
作物	さくもつ	produce (e.g. agricultural), crops.
素敵	すてき	lovely, dreamy, beautiful, great, fantastic, superb, cool, capital.
達する	たっする	to reach, to get to.
無駄	むだ	futility, uselessness, pointlessness.
裏切る	うらぎる	to betray, to turn traitor to, to double-cross.
恐れる	おそれる	to fear, to be afraid of.
少々	しょうしょう	just a minute, small quantity.
何で	なんで	why?, what for?., how?, by what means?.
沖	おき	open sea.
学期	がっき	school term, semester.
機嫌	きげん	humour, humor, temper, mood, spirits., safety, health, well-being, one's situation., in a good mood, in high spirits, happy, cheery, merry, chipper.
決心	けっしん	determination, resolution.
嫌う	きらう	to hate, to dislike, to loathe.
合図	あいず	sign, signal.
次第	しだい	dependent upon., as soon as, immediately (upon)., circumstances., order, precedence, program, programme, agenda.
組む	くむ	to cross (legs or arms), to link (arms)., to put together, to construct, to assemble, to produce (e.g. TV program)., to braid, to plait., to grapple, to wrestle., to unite, to link up, to form an alliance., to set (e.g. type)., to issue (e.g. money order).
年中	ねんじゅう, ねんちゅう, ねんぢゅう	whole year, all year round, throughout the year., always, all the time., middle class (of a nursery school, etc.).
燃える	もえる	to burn, to get fired up.
発明	はつめい	invention., intelligent, clever.
万一	まんいち, ばんいち, まんいつ, ばんいつ	emergency, unlikely event., by some chance, by some possibility.
略	ほぼ	almost, roughly, approximately.
礼儀	れいぎ	manners, courtesy, etiquette.
追いつく	おいつく	to overtake, to catch up (with).
引用	いんよう	quotation, citation, reference.
害	がい	injury, harm, evil influence, damage.
券	けん	ticket, coupon, bond, certificate.
軒	のき	eaves., narrow aisle surrounding the core of a temple building.
好む	このむ	to like, to prefer.
硬貨	こうか	coin., hard currency.
数える	かぞえる	to count, to enumerate.
尊敬	そんけい	respect, esteem, reverence, honour, honor.
答案	とうあん	examination paper, examination script.
連れ	つれ	companion, company.
虫歯	むしば, うし, くし	cavity, tooth decay, decayed tooth, caries.
越す	こす	to cross over (e.g. mountain), to go across., to go over (e.g. with audience)., to pass time (e.g. a winter)., to surpass, to be better than, to exceed., to move house., to go, to come.
恩	おん	favour, favor, obligation, debt of gratitude.
火曜	かよう	Tuesday.
刈る	かる	to cut (hair), to mow (grass), to harvest, to clip, to shear, to reap, to trim, to prune.
苦しい	くるしい	painful, difficult, agonizing., needy, tight (budget), straitened (circumstances)., forced (smile, joke), lame (excuse), strained (interpretation)., awkward (situation), painful (position)., (after masu stem) hard to do, unpleasant.
更に	さらに	furthermore, again, after all, more and more, moreover, even more.
試す	ためす	to attempt, to test, to try out.
束	たば	bundle, bunch, sheaf.
動かす	うごかす	to move, to shift, to operate, to set in motion, to mobilize, to mobilise., to inspire, to rouse, to move (e.g. feeling), to influence., to deny, to change.
悩む	なやむ	to be worried, to be troubled.
貧しい	まずしい	poor, needy.
不可	ふか	wrong, bad, improper, unjustifiable, inadvisable., not allowed, not possible., failing grade.
予期	よき	expectation, assume will happen, forecast.
注ぐ	そそぐ	to pour (into), to fill., to sprinkle on from above, to shed (e.g. tears)., to concentrate one's spirit (strength, attention) on., to fall onto (of rain, snow).
幸運	こううん	good luck, fortune.
見当	けんとう	aim, mark, estimate, guess, approximation, direction.
粗末	そまつ	crude, rough, plain, humble, shabby.
知能	ちのう	intelligence, intellect, brains.
適度	てきど	moderate.
髪の毛	かみのけ	hair (head).
愉快	ゆかい	pleasant, happy.
有能	ゆうのう	able, capable, efficient, skill.
両替	りょうがえ	change, money exchange.
脇	わき	armpit, under one's arm, side, flank., beside, close to, near, by., aside, to the side, away, out of the way., off-track, off-topic., deuteragonist, supporting role., second verse (in a linked series of poems).
頼る	たよる	to rely on, to have recourse to, to depend on.
引っ張る	ひっぱる	to pull, to draw, to pull tight., to string (lines), to run (cable), to stretch., to pull towards oneself (e.g. someone's sleeve)., to drag, to haul, to tow., to lead (e.g. one's followers)., to take someone somewhere (e.g. a suspect to the police)., to tempt into joining, to strongly invite to join., to delay, to prolong., to lengthen the pronunciation (of a word)., to quote, to cite, to reference., to pull the ball., to wear, to put on.
握る	にぎる	to clasp, to grasp, to grip, to clutch., to make (nigirizushi, rice ball, etc.), to form, to press into shape, to mold, to mould., to seize (power, etc.), to take hold of.
加減	かげん	addition and subtraction., allowance for., degree, extent, measure., condition, state of health., seasoning, flavor, flavour, moderation, adjustment., influence (of the weather)., chance.
確かめる	たしかめる	to ascertain, to check, to make sure.
恐ろしい	おそろしい	terrible, dreadful, terrifying, frightening, frightened., surprising, startling, tremendous, amazing.
減らす	へらす	to abate, to decrease, to diminish, to shorten.
減る	へる	to decrease (in size or number), to diminish, to abate.
黒板	こくばん	blackboard.
鎖	くさり	chain, chains.
書斎	しょさい	study, library, den, home office, reading room.
助ける	たすける	to help, to save, to rescue, to give relief to, to spare (life), to reinforce, to promote, to abet.
尻	しり	buttocks, behind, rump, bottom., undersurface, bottom., last place, end., consequence.
通す	とおす	to stick through, to force through., to spread throughout, to thoroughly diffuse., to make a path between two points., to proceed in a logical manner., to let pass, to allow through., to lead (someone) into (a house, room, etc.), to show in., to go through (a middleman)., to (look, listen) through (a window, wall, etc.)., to pass (a law, applicant, etc.)., to force to accept, to force agreement., to continue (in a state), to persist in., to do to the entirety of, to cover all of, to span the whole ...., to do from beginning to end without a break., to convey (one's ideas, etc.) to the other party., (after the -te form of a verb) to do to the end, to carry through, to complete.
辺り	あたり, ほとり	on the bank of, by the side of (e.g. a river, pond)., (in the) neighbourhood, neighborhood, vicinity, nearby.
育つ	そだつ	to be raised (e.g. child), to be brought up, to grow (up).
加わる	くわわる	to be added to, to be appended., to join in (e.g. a group of friends), to participate., to increase (e.g. heat), to gain in (e.g. influence), to grow, to gather (speed)., to be subject to (e.g. pressure).
申し訳	もうしわけ	apology, excuse.
正確	せいかく	accurate, punctual, exact, authentic, veracious.
眺める	ながめる	to view, to gaze at.
縄	なわ	rope, cord., policeman's rope.
預ける	あずける	to give into custody, to leave (a child) in the care of, to entrust, to deposit., to lean on, to put one's weight on.
陽気	ようき	cheerful, jovial, merry, lively., weather, season., spirit of yang.
お前	おまえ, おまい, おめえ	you (formerly honorific, now sometimes derog. term referring to an equal or inferior)., presence (of a god, nobleman, etc.).
今に	いまに	before long, even now.
倒す	たおす	to throw down, to bring down, to blow down, to fell, to knock down, to set (something) down on its side, to turn (something) on its side., to kill, to defeat, to beat., to overthrow, to trip up, to ruin., to leave unpaid, to cheat.
命じる	めいじる	to order, to command, to appoint.
用いる	もちいる	to use, to make use of, to utilize, to utilise.
激しい	はげしい	violent, furious, tempestuous., extreme, intense, fierce., fervent, vehement., incessant, relentless.
悲しむ	かなしむ	to be sad, to mourn for, to regret.
癖	くせ, へき	habit (often a bad habit, i.e. vice), tendency., peculiarity, idiosyncrasy, mannerism., crease, wrinkle, curl, kink.
戻す	もどす	to put back, to return, to give back, to restore (to a previous state, e.g. defrosting, reconstituting, reconciling), to turn back (e.g. clock hand)., to vomit, to throw up., to recover (of a market price).
厄介	やっかい	trouble, burden, nuisance, bother, worry., care, dependence, support, kindness, obligation, staying (with a person).
籠	かご	basket (shopping, etc.), hamper, cage.
可哀相	かわいそう	poor, pitiable, pathetic, pitiful.
度々	たびたび	often, again and again, over and over again, repeatedly, frequently.
噂	うわさ	rumour, rumor, report, hearsay, gossip, common talk.
加える	くわえる	to add, to add up, to sum up, to append, to annex., to increase, to gather (e.g. speed), to pick up., to include, to count in, to let join., to inflict (damage), to deal, to give.
試し	ためし	trial, test.
祝う	いわう	to congratulate, to celebrate, to observe (a festival).
親しい	したしい	intimate, close (e.g. friend).
閉じる	とじる	to close (e.g. book, eyes, meeting, etc.), to shut.
雇う	やとう	to employ., to hire, to charter.
決まり	きまり	rule, regulation., settlement, conclusion, end, agreement, arrangement., habit, custom, habitual way., countenance in front of another person, face.
彼方此方	あちこち, あちらこちら, あっちこっち, かなたこなた, あなたこなた, アチコチ	here and there., to get things in the wrong order (back to front), to become muddled up.
伸びる	のびる	to stretch, to extend, to lengthen, to spread., to make progress, to grow (beard, body height)., to grow stale (soba)., to be straightened, to be flattened, to be smoothed., to be exhausted., to be postponed, to be prolonged.
頬	ほお, ほほ	cheek (of face).
インク		ink.
地区	ちく	district, section, sector.
意思	いし	intention, purpose.
貢献	こうけん	contribution (furthering a goal or cause), services (to a cause).
何も	なにも	nothing (with neg. verbs), not any., and everything else (with noun plus "mo"), all.
具体	ぐたい	concrete, tangible, material.
銃	じゅう	gun, rifle, small arms.
他	た	other (esp. people and abstract matters).
食糧	しょくりょう	food (esp. staple food such as rice or wheat), provisions, rations, food supply.
宅	たく	house, home, husband.
幕	まく	curtain, bunting., act (in play).
予測	よそく	prediction, estimation.
次々	つぎつぎ	in succession, one by one.
王	おう	king, ruler, sovereign, monarch., king (for senior player) (shogi)., tycoon, magnate, champion, master.
詩	し	poem, verse of poetry.
支給	しきゅう	provision, supply, payment, allowance, grant.
同僚	どうりょう	coworker, co-worker, colleague, associate.
級	きゅう	class, grade, rank, school class, grade.
職	しょく, そく	job, work, employment, occupation, position., duties., trade, skill.
取り上げる	とりあげる	to pick up, to take up., to adopt, to feature, to accept, to listen to., to take away, to confiscate, to deprive, to disqualify., to deliver (a child).
伸ばす	のばす	to grow long (e.g. hair, nails)., to lengthen, to extend, to stretch., to reach out, to hold out., to straighten, to smooth out., to spread evenly (dough, cream, etc.)., to dilute, to thin out., to postpone., to prolong., to strengthen, to develop, to expand.
菓子	かし	pastry, confectionery.
絶滅	ぜつめつ	destruction, extinction.
快適	かいてき	pleasant, agreeable, comfortable.
捕まる	つかまる	to be caught, to be arrested., to hold on to, to grasp., to find (e.g. proof), to get (e.g. a taxi)., to be detained by.
便	びん	flight (e.g. airline flight), trip (e.g. train trip), service., mail, post, letter., opportunity, chance.
人ごみ	ひとごみ	crowd of people.
豆	まめ	legume (esp. edible legumes or their seeds, such as beans, peas, pulses, etc.), beans, peas., soya bean (soybean), soy (Glycine max)., female genitalia (esp. the clitoris)., kidney., miniature, tiny., child.
勧める	すすめる	to recommend, to advise, to encourage, to offer (wine).
学	がく	-ology, -ics, study of ...., learning, scholarship, erudition, knowledge.
段	だん	step, stair, (flight of) steps, (row of) stitches, columns (of print)., grade, rank, level., counter for breaks in written language (or speech, etc.).
老い	おい	old age, old person, the old, the aged.
餌	えさ, え	feed, bait.
学ぶ	まなぶ	to study (in depth), to learn, to take lessons in.
似合う	にあう	to suit, to match, to become, to be like.
真剣	しんけん	seriousness, earnestness., real sword (as opposed to unsharpened or wooden practice weapon).
霜	しも	frost.
袖	そで	sleeve., wing (of a stage).
地平線	ちへいせん	horizon (related to land).
遅刻	ちこく	lateness, late coming.
通り過ぎる	とおりすぎる	to pass, to pass through.
得る	うる	(after the -masu stem of a verb) to be able to ..., can ...., to get, to acquire, to obtain, to procure, to earn, to win, to gain, to secure, to attain.
発車	はっしゃ	departure of a vehicle.
罰する	ばっする	to punish, to penalize, to penalise.
防ぐ	ふせぐ	to defend (against), to protect, to prevent.
割る	わる	to divide, to cut, to break, to halve, to separate, to split, to rip, to crack, to smash, to dilute.
居眠り	いねむり	nodding off (while sitting), dozing.
強調	きょうちょう	emphasis, highlight, stress, stressed point.
行儀	ぎょうぎ	manners, behavior, behaviour.
飼う	かう	to keep (a pet or other animal), to raise, to have, to own, to feed.
反抗	はんこう	opposition, resistance, insubordination, defiance, hostility, rebellion.
飛ばす	とばす	to fly, to fire, to hurl, to launch, to make fly., to skip over, to omit, to drop (e.g. stitch)., to run or drive fast, to gallop., to spread a rumour (rumor), to tell a story, to tell a joke., to remove, to get rid of, to transfer., to attack, to jeer at.
包み	つつみ	bundle, package, parcel, bale.
要点	ようてん	gist, main point.
劣る	おとる	to be inferior to, to be less good at, to fall behind.
論じる	ろんじる	to argue, to discuss, to debate.
飽きる	あきる	to get tired of, to lose interest in, to have enough.
満ちる	みちる	to be full., to wax (e.g. moon)., to rise (e.g. tide)., to mature, to expire.
途端	とたん	just (now, at the moment, etc.).
膝	ひざ	knee, lap.
含む	ふくむ, くくむ	to contain, to comprise, to have, to hold, to include, to embrace., to hold in the mouth., to bear in mind, to understand, to harbor (grudge, etc.), to harbour., to express (emotion, etc.), to imply.
気の毒	きのどく	pitiful, unfortunate, (a) pity.
手品	てじな	sleight of hand, conjuring trick, magic, juggling.
与える	あたえる	to give (esp. to someone of lower status), to bestow, to grant, to confer, to present, to award., to provide, to afford, to offer, to supply., to assign., to cause., to pass (a variable to a function).
用心	ようじん	care, precaution, guarding, caution.
連想	れんそう	association (of ideas), being reminded (of something), suggestion.
例え	たとえ	example., simile, metaphor, allegory, fable, parable.
眺め	ながめ	scene, view, prospect, outlook.
去る	さる	to leave, to go away., to pass, to elapse., to be distant., to send away, to drive off, to divorce., ... completely., last ... (e.g. "last April").
狂う	くるう	to go mad., to get out of order, to go amiss.
作法	さほう, さくほう	manners, etiquette, propriety., manner of production (esp. of prose, poetry, etc.), way of making.
不平	ふへい	complaint, discontent, dissatisfaction.
賢い	かしこい	wise, clever, smart.
親戚	しんせき	relative, relation, kin.
迷子	まいご	lost child, lost person, stray child, missing child.
離す	はなす	to separate, to part, to divide, to keep apart.
泳ぎ	およぎ	swimming.
過ごす	すごす	to pass (time), to spend., to overdo (esp. of one's alcohol consumption), to drink (alcohol)., to overdo, to do too much., to ... without acting on it.
願う	ねがう	to desire, to wish, to hope., to beg, to request, to implore, to pray., to have something done for oneself.
及ぼす	およぼす	to exert, to cause, to exercise.
上達	じょうたつ	improvement (e.g. in skill, ability), advance, progress., communication of opinions of the general populace to those of high rank.
気付く	きづく	to notice, to recognize, to recognise, to become aware of, to perceive, to realize, to realise.
詰まり	つまり	that is to say, that is, in other words, I mean., in short, in brief, to sum up, ultimately, in the end, in the long run, when all is said and done, what it all comes down to, when you get right down to it, basically., clogging, obstruction, stuffing, (degree of) blockage., shrinkage., end, conclusion.
訓	くん, くに	native Japanese reading (rendering) of a Chinese character.
兎	うさぎ, う, ウサギ	rabbit, hare, coney, cony, lagomorph (esp. leporids).
濃い	こい	deep (colour), dark., strong (flavour, smell, etc.)., thick (consistency), dense., strong (possibility, etc.)., thick (i.e. "as thick as thieves"), close, deep (love, etc.).
暗記	あんき	memorization, memorisation, learning by heart.
凍る	こおる	to freeze, to be frozen over, to congeal.
動詞	どうし	verb.
秒	びょう	second (60th min).
物音	ものおと	sounds.
食う	くう	to eat., to live, to make a living, to survive., to bite, to sting (as insects do)., to tease, to torment, to taunt, to make light of, to make fun of., to encroach on, to eat into, to consume., to defeat a superior, to threaten a position., to consume time and-or resources., to receive something (usu. an unfavourable event)., to have sexual relations with a woman, esp. for the first time.
広がる	ひろがる	to spread (out), to extend, to stretch, to reach to, to get around, to fill (e.g. a space).
基づく	もとづく	to be grounded on, to be based on, to be due to, to originate from.
対する	たいする	to face (each other), to be facing., to be directed toward (the future, etc.), to be in response to, to be related to., to receive (a client, etc.)., to compare with, to contrast with, to be in opposition with, to be opposed to., to confront, to oppose, to compete with.
哀れ	あわれ	pity, sorrow, grief, misery, compassion, pathos., pitiable, pitiful, pathetic, miserable., alack, alas.
徐々	じょじょ	gradually, steadily, quietly, slowly, little by little., soon.
生じる	しょうじる	to produce, to yield, to cause., to result from, to arise, to be generated.
夢中	むちゅう	daze, (in a) trance, ecstasy, delirium, engrossment, within a (deep) dream.
約	やく	approximately, about., promise., shortening, reduction, simplification., contraction (in phonetics).
横切る	よこぎる	to cross (e.g. road), to traverse.
積もる	つもる	to pile up, to accumulate., to estimate.
適する	てきする	to fit, to suit.
当たる	あたる	to be hit, to strike., to touch, to be in contact, to be affixed., to be equivalent to, to be applicable, to apply to., to be right on the money (of a prediction, criticism, etc.)., to be selected (in a lottery, etc.), to win., to be successful, to go well, to be a hit., to face, to confront., to lie (in the direction of)., to undertake, to be assigned., to be stricken (by food poisoning, heat, etc.), to be afflicted., to be called upon (by the teacher)., to treat (esp. harshly), to lash out at., to be unnecessary., to be hitting well, to be on a hitting streak., (in fishing) to feel a bite., (of fruit, etc.) to be bruised, to spoil., to feel (something) out, to probe into, to check (i.e. by comparison)., to shave., to be a relative of a person, to stand in a relationship.
転ぶ	ころぶ, まろぶ	to fall down, to fall over.
クラシック		classical music., classic, classical., (the) classics.
ケース		case (e.g. receptacle, condition, event, legal action, letter style, etc.)., Computer-Aided Software Engineering, CASE.
バイオリン		violin.
因る	よる	to be due to, to be caused by., to depend on, to turn on., to be based on, to come from.
認める	みとめる	to recognize, to recognise, to observe, to notice., to deem, to judge, to assess., to approve, to deem acceptable, to allow., to admit, to accept, to confess (to a charge)., to watch steadily, to observe carefully., to renown, to give renown to, to appreciate, to acknowledge.
付ける	つける	to attach, to join, to add, to append, to affix, to stick, to glue, to fasten, to sew on, to apply (ointment)., to furnish (a house with)., to wear, to put on., to keep a diary, to make an entry., to appraise, to set (a price)., to bring alongside., to place (under guard or doctor)., to follow, to shadow., to load, to give (courage to)., to keep (an eye on)., to establish (relations or understanding)., to turn on (light).
腐る	くさる	to rot, to go bad, to decay, to spoil, to fester, to decompose, to turn sour (e.g. milk)., to corrode, to weather, to crumble., to become useless, to blunt, to weaken (from lack of practice)., to become depraved, to be degenerate, to be morally bankrupt, to be corrupt., to be depressed, to be dispirited, to feel discouraged, to feel down., indicates scorn or disdain for another's action.
避ける	さける, よける	to avoid (physical contact with)., to avoid (situation)., to ward off, to avert.
抱く	いだく, だく, うだく	to embrace, to hold in the arms (e.g. a baby), to hug., to harbour (e.g. grudge) (harbor), to bear (e.g. a grudge), to entertain (e.g. suspicion)., to have sex with, to make love to, to sleep with., to sit on eggs.
有り難う	ありがとう	Thank you, Thanks.
下ろす	おろす	to take down (e.g. flag), to launch (e.g. boat), to drop, to lower (e.g. ladder), to let (a person) off, to unload, to discharge., to drop off (a passenger from a vehicle), to let (a person) off., to withdraw money from an account., to wear (clothing) for the first time., to fillet (e.g. a fish).
効く	きく	to be effective, to show effect., to do its work, to carry out its function well., to be possible to use.
一人一人	ひとりひとり, ひとりびとり	one by one, each, one at a time.
例	れい	custom, practice, habit, usual., said, aforementioned., instance, example, case, illustration, usage., precedent.
鼠	ねずみ, ネズミ, ねず	mouse, rat., dark gray, dark grey, slate (color, colour).
無し	なし	without., unacceptable, not alright, unsatisfactory.
関する	かんする	to concern, to be related.
辞める	やめる	to resign, to retire, to quit, to leave (one's job, etc.).
信じる	しんじる	to believe, to believe in, to place trust in, to confide in, to have faith in.
停留所	ていりゅうじょ	bus stop, tram stop, stop, station.
刷る	する	to print., to color or pattern fabric using a wooden mold.
譲る	ゆずる	to turn over, to assign, to hand over, to transmit, to convey, to sell, to dispose of., to yield, to surrender, to concede.
申し込む	もうしこむ	to apply for, to make an application, to propose (marriage), to offer (mediation), to make an overture (of peace), to challenge, to lodge (objections), to request (an interview), to subscribe for, to book, to reserve.
酔う	よう	to get drunk, to become intoxicated., to feel sick (e.g. in a vehicle), to become nauseated., to be elated, to be exalted, to be spellbound, to be in raptures.
訴える	うったえる	to raise, to bring to (someone's attention)., to appeal to, to call for., to complain., to sue (a person), to take someone to court., to resort to (e.g. arms, violence).
熱中	ねっちゅう	going nuts (over something), enthusiasm, zeal, mania.
暮らす	くらす	to live, to get along., to spend (time).
咳	せき, しわぶき	cough, coughing, tussis.
逆らう	さからう	to go against, to oppose, to disobey, to defy.
退屈	たいくつ	tedium, boredom.
覚める	さめる	to wake, to wake up., to become sober, to sober up, to regain consciousness (e.g. after anaesthesia)., to come to one's senses, to be disillusioned.
経つ	たつ	to pass, to lapse.
沈む	しずむ	to sink, to feel depressed, to descend.
等しい	ひとしい	equal, similar, like, equivalent.
紐	ひも	string, cord., man who is financially dependent on a woman (such as a gigolo or, in the case of a prostitute, a pimp), pimp.
異なる	ことなる	to differ, to vary, to disagree.
稼ぐ	かせぐ	to earn income, to labor, to labour.
気に入る	きにいる	to be pleased with, to suit.
振る	ふる	to wave, to shake, to swing., to sprinkle, to throw (dice)., to cast (actor), to allocate (work)., to turn down (somebody), to reject, to jilt, to dump., to abandon, to give up, to ruin., to add kana indicating a reading of a word., to slightly change headings, to change directions., to extract by broiling, to prepare an infusion of, to decoct., to carry with great vigor (e.g. a portable shrine)., to bring up the main topic., to replace, to substitute., to set up a joke for somebody else.
真似	まね	imitating, copying, mimicry., behavior, behaviour, action, conduct.
粗い	あらい	coarse, rough.
利口	りこう	clever, intelligent, wise, bright, sharp, sensible, smart, shrewd., well-behaved (of kids, animals, etc), obedient, good.
立ち上がる	たちあがる	to stand up, to get up., to rise., to recover., to take action, to start., to make the initial charge., to start up, to boot up.
最中	さいちゅう, さなか	in the middle of, height of, in course of, midst.
覚ます	さます	to awaken., to disabuse., to sober up., to dampen, to throw a damper on, to spoil.
蕎麦	そば, そばむぎ, そまむぎ	buckwheat (Fagopyrum esculentum)., soba, Japanese buckwheat noodles.
指す	さす	to point., to nominate, to select someone, to specify some person., to identify, to indicate, to point out., to play (shogi)., to extend one's arm straight ahead (in dance).
上等	じょうとう	superiority, first-class, very good., (that's) just fine!, bring it on!.
即ち	すなわち	that is, namely, i.e..
余分	よぶん	extra, excess, surplus.
贅沢	ぜいたく	luxury, extravagance., to live in luxury.
器用	きよう	skillful, skilful, handy.
幼い	おさない, いとけない	very young., childish, immature.
仮令	たとえ, たとい	even if, if, though, although, supposing, supposing that.
苦しむ	くるしむ	to suffer, to groan, to be worried.
正に	まさに	exactly, surely, certainly., just (about to), on the verge (of doing or happening)., duly, naturally.
責める	せめる	to condemn, to blame, to criticize, to criticise, to reproach, to accuse., to urge, to press, to pester., to torture, to torment, to persecute., to break in (a horse).
頂戴	ちょうだい	receiving, reception, getting, being given., eating, drinking, having., please, please do for me.
通じる	つうじる	to be open (to traffic), to lead to, to communicate (with)., to flow (liquid, current), to pass, to get through to., to be understood, to be comprehended., to be honored, to be good., to be well versed in, to be well-informed., to communicate clandestinely, to keep in touch (e.g. with the enemy)., to form a liaison, to be intimate., to spread widely, to disseminate.
放す	はなす	to release, to let go, to free, to set free, to let loose, to turn loose., to add (pieces of eggplant, potato, etc.) to water, broth, etc..
馬鹿	ばか, バカ	fool, idiot., trivial matter, folly, absurdity., foolish, stupid, dull, absurd, ridiculous., Mactra chinensis (species of trough shell).
至る	いたる	to arrive at (e.g. a decision), to reach (a stage), to attain., to lead to (a place), to get to.
従う	したがう	to abide (by the rules), to obey, to follow, to accompany.
述べる	のべる	to state, to express, to mention.
増す	ます	to increase, to grow.
大屋	おおや	landlord, landlady.
流れる	ながれる	to stream, to flow (liquid, time, etc.), to run (ink)., to be washed away, to be carried., to drift, to float (e.g. clouds), to wander, to stray., to sweep (e.g. rumour, fire), to spread, to circulate., to be heard (e.g. music), to be played., to lapse (e.g. into indolence, despair)., to pass, to elapse, to be transmitted., to be called off, to be forfeited., to disappear, to be removed.
お喋り	おしゃべり	chattering, talk, idle talk, chat, chitchat, gossip., chatty, talkative, chatterbox, blabbermouth.
かも知れない	かもしれない	may, might, perhaps, may be, possibly.
頻りに	しきりに	frequently, repeatedly, often, incessantly, constantly., strongly, eagerly.
屡々	しばしば	often, again and again, frequently.
仕舞った	しまった	damn it!, damn!, oops!, oh dear!, oh no!.
その内	そのうち	before very long, soon, eventually, sooner or later, of the previously mentioned.
其れ共	それとも	or, or else.
所が	ところが	even so, however, still, whereupon, even though, nevertheless, on the contrary, as a matter of fact, despite.
何故なら	なぜなら	because, the reason is, if you want to know why.
軈て	やがて	before long, soon., almost, nearly., finally, in the end, eventually.
アイスクリーム		ice cream, icecream.
アイロン		iron (for pressing clothes)., hair iron, hair tong, curling tong.
アウト		out.
アルバム		album.
ウィスキー		whisky, whiskey.
エネルギー		energy., strength, power, stamina, get-up-and-go., food energy, calories.
エンジン		engine.
カード		card., curd.
キッチン		kitchen., chitin.
キャンプ		camp.
クリーム		cream.
クリスマス		Christmas.
グラス		glass (drinking vessel)., glass., glasses., grass.
グループ		group (usu. of people).
ゲーム		game.
コーチ		coach.
コード		code., cord., chord.
ゴール		goal., Gaul.
サービス		service, help, assistance, care, concern., discount, freebie, free gift., service, serve., service, servicing, (product) maintenance.
サイン		autograph, signature., sign., sine.
シャベル		shovel.
ジェット機	ジェットき	jet aeroplane, jet airplane.
ジュース		juice., soft drink (any (sweet) non-alcoholic beverage, carbonated or uncarbonated)., deuce.
スープ		(Western) soup.
スイッチ		switch.
スキー		skiing., ski, skis.
スケート		skate, skates, skating.
スター		star (cinema, sports, etc.), celebrity, idol., star symbol, asterisk., (celestial) star.
スタイル		style., (female) figure.
スタンド		stands, bleachers., stand (e.g. newspaper stand), counter (e.g. lunch counter)., stand (e.g. inkstand)., desk lamp, floor lamp, standard lamp., station (e.g. gas station).
スピーチ		speech.
セット		set., set meal., hairdo.
センター		centre, center.
ソファ		sofa, couch.
タイプライター		typewriter.
タオル		(hand) towel.
ダイヤ		diamond., (railway) schedule., diagram., dyer.
ダンス		dance.
チーズ		cheese., say cheese! (when taking photographs).
チーム		team.
チャンス		chance, opportunity.
テント		tent.
デート		date, go on a date.
トップ		top., top position., senior management, senior bureaucrat.
トラック		truck., track (running, CD, DVD, etc.).
トランプ		playing cards (from trump).
トンネル		tunnel., fielding error (baseball).
ドライブ		drive, trip by car, driving., to (go for a) drive, to go on a trip by car., to drive (e.g. a car)., to drive (innovation, change, etc.), to propel.
ドラマ		drama., TV drama, teledrama, play.
ドレス		dress.
ノック		knock., fungo (baseball).
ハイキング		hiking.
ハンサム		handsome.
バッグ		bag.
パーセント		percent, percentage.
パイプ		pipe, tube., channels, official or otherwise, (business) connections., tobacco pipe.
パイロット		pilot.
パスポート		passport.
ビデオ		video.
ピクニック		picnic.
ピン		pin (e.g. hairpin, bowling pin, golf pin, etc.)., one (on dice, in cards, etc.)., beginning, best., kickback.
ブレーキ		brake.
プラス		plus, addition., positive number., gain, advantage, asset, positive feature., anode, plus terminal, positive pole., + shape.
プラン		plan.
プロ		professional.
ベルト		belt (waist, seat, etc.), strap., belt, zone, area., drive belt, machine belt.
ベンチ		bench.
ペンキ		paint.
ホーム		platform., home.
ボーイ		boy., bellboy, porter, waiter.
ボート		boat, rowing boat.
ボール		ball., bowl., board (e.g. cardboard, pasteboard).
マーケット		market.
マイク		mike, mic, microphone.
ママ		Mama., female proprietress (of a bar, etc.).
ミス		mistake, error, failure., Miss., myth.
ミルク		milk.
メモ		memo, note, memorandum.
メンバー		member, participant, attendee, lineup (sport).
ユーモア		humor, humour.
ヨット		yacht (usually only used for a sailing boat with one mast).
ライター		lighter., writer.
ラケット		racket, paddle (in table-tennis).
ロケット		locket., rocket.
ワイン		wine.
悪戯	いたずら, いたづら	mischief, prank, trick, practical joke., pastime, hobby., playing with (a lighter, etc.), fooling around with, messing around with, amusing oneself with, tampering with., lewd behaviour, sexual misconduct, sexual assault, molestation, rape.
案	あん	idea, plan, thought., draft plan, motion, rough copy., expectation.
位	くらい	throne, crown, (nobleman's) seat., government position, court rank., social standing, rank, class, echelon, rung., grade (of quality, etc.), level, tier, rank., digit (e.g. the tens, the hundreds, etc.), place., degree, extent, amount.
隠れる	かくれる	to hide, to be hidden, to conceal oneself, to disappear.
何時までも	いつまでも	forever, for good, eternally, as long as one likes, indefinitely, no matter what.
何処か	どこか, どっか	somewhere, anywhere, in some respects.
可愛らしい	かわいらしい	lovely, sweet.
我が儘	わがまま	selfishness, egoism, self-indulgence, wilfulness, willfulness., disobedience., whim.
解く	とく	to untie, to unfasten, to unwrap, to undo, to unbind, to unpack., to unsew, to unstitch., to solve, to work out, to answer., to dispel (misunderstanding, etc.), to clear up, to remove (suspicion), to appease., to dissolve (a contract), to cancel, to remove (a prohibition), to lift (a ban), to raise (a siege)., to release (from duty), to relieve, to dismiss., to comb (out), to card, to untangle (hair).
灰	はい	ash, ashes.
角	つの	horn.
額	ひたい	forehead, brow.
堪らない	たまらない	intolerable, unbearable, unendurable., irresistible, tremendous, out of this world., cannot help (doing), cannot but do, anxious to do.
間	ま	space, room, time, pause.
丸	まる	circle., entirety, whole, full, complete., money, dough, moola., enclosure inside a castle's walls., soft-shelled turtle., suffix for ship names, suffix for names of people (esp. infants), suffix for names of swords, armour, musical instruments, etc., suffix for names of dogs, horses, etc..
丸で	まるで	quite, entirely, completely, at all., as if, as though, just like.
輝く	かがやく	to shine, to glitter, to sparkle.
詰める	つめる	to stuff into, to jam, to cram, to pack, to fill, to plug, to stop up., to shorten, to move closer together., to reduce (spending), to conserve., to focus intently on, to strain oneself to do., to work out (details)., to be on duty, to be stationed., to corner (esp. an opponent's king in shogi), to trap, to checkmate., to cut off (one's finger as an act of apology), to catch (one's finger in a door, etc.)., to continue ..., to keep doing ... without a break., to do ... completely, to do ... thoroughly., to force someone into a difficult situation by ....
求める	もとめる	to want, to wish for., to request, to demand., to seek, to search for, to pursue (pleasure), to hunt (a job)., to purchase, to buy.
旧	きゅう	ex-, former, old.
僅か	わずか	only, merely, (a) little, small quantity.
近頃	ちかごろ	lately, recently, nowadays.
金	かね, かな	money., metal.
金	きん	gold (Au), golden (color), gold (medal, cup)., valuable, of highest value., gold coin, money., Friday., metal (fourth of the five elements)., Jin (dynasty of China; 1115-1234 CE)., gold general (shogi)., testicles., karat, carat.
繋ぐ	つなぐ	to tie, to fasten, to connect, to transfer (phone call).
欠ける	かける	to be chipped, to be damaged, to be broken., to be lacking, to be missing., to be insufficient, to be short, to be deficient, to be negligent toward., (of the moon) to wane, to go into eclipse.
県	けん	prefecture (of Japan)., county (of China).
原	はら	field, plain, prairie, tundra, moor, wilderness.
諺	ことわざ	proverb, maxim.
後	のち	later, afterwards, since., future., after one's death.
お目出度う	おめでとう	congratulations!, an auspicious occasion!.
向く	むく	to face., to turn toward., to be suited to, to be fit for.
向ける	むける	to turn towards, to point.
今にも	いまにも	at any time, soon.
済ませる	すませる	to finish, to make an end of, to get through with, to let end.
札	さつ	note, paper money.
市	いち	market, fair.
支える	ささえる	to support, to prop, to sustain, to underlay, to hold up., to hold at bay, to stem, to check.
止す	よす	to cease, to desist, to cut it out, to lay off (an activity), to drop (a subject) to abolish, to resign, to give up.
者	もの, もん	person.
取れる	とれる	to come off, to be removed., (of pain, a fever, etc.) to disappear., to be caught, to be harvested., to be interpreted (as), to be taken as., (of balance, etc.) to be attained., to be obtainable.
就く	つく	to ascend (the throne), to accede., to take (seat, position, course, etc.), to assume., to start (on a journey), to commence, to depart., to study (under teacher), to be an apprentice.
臭い	くさい	stinking, smelly., suspicious, fishy., clumsy.
従兄弟	いとこ, じゅうけいてい	cousin (male).
所で	ところで	by the way, incidentally., even if, no matter (who, what, when, where, why, how).
所謂	いわゆる	what is called, as it is called, the so-called, so to speak.
除く	のぞく	to remove, to eliminate, to eradicate., to exclude, to except.
少しも	すこしも	anything of, not one bit (with negative sentence).
床	ゆか	floor., stage (for the narrator and the shamisen player)., dining platform built across a river.
招く	まねく	to invite, to ask., to beckon, to wave someone in, to gesture to., to call in, to send for, to summon., to bring on oneself, to cause, to incur, to lead to, to result in.
省く	はぶく	to omit, to leave out, to exclude, to eliminate., to curtail, to save, to cut down, to economize, to economise.
象	ぞう	elephant.
上	かみ	upper reaches (of a river), upper stream., top, upper part, upper half (of the body)., long ago., beginning, first., person of high rank (e.g. the emperor)., government, imperial court., imperial capital (i.e. Kyoto), capital region (i.e. Kansai), region (or direction of) the imperial palace., head (of a table)., wife, mistress (of a restaurant).
上	じょう	from the standpoint of, as a matter of (e.g. fact), in the field of, being of the type of., aboard (a ship or vehicle), on top of, on, above., first volume (e.g. book)., superior quality, best, top, high class., going up., governmental, imperial., presenting, showing., ana- (medical, biol.).
場	ば	place, spot, space., field, discipline, sphere, realm., occasion, situation., scene (of a play, movie, etc.)., session (of the stock market)., area in which cards are laid out (in a card game)., round (mahjong, i.e. east, south, etc.)., field., field (gestalt psychology).
触れる	ふれる	to touch, to feel., to experience, to come in contact with, to be emotionally moved (by), to perceive., to touch on a subject, to allude to., to be in conflict (with), to violate (law, copyright, etc.)., to proclaim.
真逆	まさか	by no means, never!, well, I never!, you don't say!, certainly (not)., something unexpected, emergency., indeed, really, truly, unexpectedly.
辛い	つらい	painful, bitter, heart-breaking.
進める	すすめる	to advance, to promote, to hasten.
震える	ふるえる	to shiver, to shake, to quake, to tremble, to quaver, to quiver.
遂に	ついに	finally, at last., in the end.
性	せい	nature (of a person)., sex., gender., -ty, -ity, -ness, -cy.
生	なま	raw, uncooked, fresh., natural, as it is, unedited, unprocessed., unprotected (i.e. not wearing a condom)., live (i.e. not recorded)., inexperienced, unpolished, green, crude., impudence, sauciness., unpasteurized beer, draft beer, draught beer., just a little, somehow, vaguely, partially, somewhat, half-, semi-., irresponsibly, half-baked., tipsiness.
生憎	あいにく	unfortunately, Sorry, but ....
切れ	きれ	piece, slice, strip, scrap., cloth., sharpness., counter for scraps, pieces, etc..
切れる	きれる	to break, to snap, to be cut, to split, to crack., to be injured., to wear out, to be worn out., to break, to burst, to collapse., to wear off, to stop working, to go dead., to expire (time limit, etc.), to run out, to become due., to run out (of stock, etc.), to be exhausted, to be used up, to be sold out, to be out of., to be broken off (e.g. of a relationship), to break up, to have severed ties, to be cut off, to be disconnected., to cut well, to be sharp., to be sharp-minded, to be keen, to be shrewd, to be quick-witted, to be able., to be short of, to drop under (a certain figure), to beat (e.g. a record time)., to dry off., to curve, to veer., to shuffle (cards)., to get angry, to snap, to blow one's top, to lose one's temper, to flip., to be able to do completely.
節	ふし	joint, knuckle., tune, melody., knot (in wood), node in a bamboo stem., part, notable characteristic.
説	せつ	theory, doctrine., opinion, view., rumour, rumor, gossip, hearsay.
占める	しめる	to occupy, to hold., to account for, to make up, to take up.
全く	まったく	really, truly, entirely, completely, wholly, perfectly., indeed., good grief (expression of exasperation).
其の儘	そのまま, そのまんま	without change, as it is (i.e. now).
其れでも	それでも	but (still), and yet, nevertheless, even so, notwithstanding.
其処で	そこで	so, accordingly, now, then, thereupon, therefore.
打つ	ぶつ	to hit (a person), to strike, to beat.
対	たい	opposite, opposition., versus, vs., v.., to (i.e. "we won the game five to three")., equal footing, equal terms., against ..., anti-, toward ..., to ....
対	つい	pair, couple, set., antithesis., counter for items that come in pairs., counter for sets (of clothes, small furniture, utensils, etc.).
帯	おび, たらし	obi, kimono sash., paper wrapper on books, CDs, etc..
怠ける	なまける	to be idle, to slacken., to neglect (e.g. one's work).
態と	わざと	on purpose.
大した	たいした	considerable, great, important, significant, a big deal.
叩く	たたく, はたく	to strike, to clap, to knock, to dust, to beat., to play drums., to abuse, to flame (e.g. on the Internet), to insult., to use up money., to call, to invoke (e.g. a function).
知らせ	しらせ	notice, notification.
喋る	しゃべる	to talk, to chat, to chatter.
直に	じかに	directly, in person, firsthand.
掴む	つかむ	to seize, to catch, to grasp, to grip, to grab, to hold, to catch hold of, to lay one's hands on, to clutch., to understand, to grasp, to comprehend.
諦める	あきらめる	to give up, to abandon (hope, plans), to resign oneself (to).
的	てき	-like, typical.
溺れる	おぼれる	to drown, to nearly drown, to sink below the surface (of water)., to indulge in, to lose one's head over something, to wallow in.
田	た	rice field.
兎に角	とにかく	anyhow, at any rate, anyway, somehow or other, generally speaking, in any case, at least.
度	たび, たんび	time (three times, each time, etc.), times.
銅貨	どうか	copper coin.
届く	とどく	to reach, to arrive, to get through, to get at., to be attentive, to pay attention., to be delivered, to carry (e.g. sound).
屯	トン	ton (now usu. a metric ton, i.e. 1,000kg), tonne.
如何しても	どうしても	by all means, at any cost, no matter what, after all, in the long run, cravingly, at any rate, surely.
任せる	まかせる	to entrust (e.g. a task) to another, to leave to., to passively leave to someone else's facilities., to leave to take its natural course., to continue (something) in a natural fashion (without particular aim)., to rely fully on one's (full strength, great ability, long time taken) to get something done.
売れる	うれる	to sell (well)., to be well known, to be popular, to be famous.
莫大	ばくだい	enormous, vast., malva nut.
抜く	ぬく	to extract, to omit, to surpass, to overtake, to draw out, to unplug., to do something to the end., to masturbate (of a male), to ejaculate (while masturbating)., to take (a photo), to record (video).
抜ける	ぬける	to come out, to fall out, to be omitted, to be missing, to escape, to come loose., to fade, to discolour., to wear a hole (e.g. clothes)., to leave (e.g. a meeting)., to be clear, to be transparent (e.g. of the sky)., to be stupid, to be absentminded, to be careless, to be inattentive., to exit (a program loop).
微笑む	ほほえむ	to smile.
表	ひょう	table (e.g. Table 1), chart, list.
仏	ほとけ	Buddha, merciful person, Buddhist image., the dead, dead person, spirit of the dead.
分	ぶん	part, segment, share, ration., rate., degree, one's lot, one's status, relation, duty, kind, lot., in proportion to, just as much as.
文	ぶん	sentence, text.
然も	しかも	moreover, furthermore, nevertheless, and yet.
平ら	たいら	flatness, level, smooth, calm, plain, sitting tailor fashion.
柄	え	handle, grip., stalk (of a mushroom, leaf, etc.).
法	ほう	law, act, principle., method., mood., dharma.
凡そ	およそ	about, roughly, as a rule, approximately.
綿	めん	cotton.
尤も	もっとも	but then, although, though., reasonable, natural, just.
優れる	すぐれる	to surpass, to outstrip, to excel.
率	りつ	rate, ratio, proportion, percentage.
量	りょう	quantity, amount, volume, portion (of food).
唸る	うなる	to groan, to moan., to roar, to howl, to growl., to hum (e.g. engine, wires in wind), to buzz, to sough, low, dull sound., to ooh and aah (in admiration)., to sing in a strong, low voice (esp. traditional chant or recitation).
埃	ほこり, ホコリ, あい	dust., one ten-billionth.
何れ	いずれ, いづれ	where, which, who., anyway, anyhow, at any rate, sooner or later, eventually, at some future date or time.
稍	やや	a little, partially, somewhat, slightly, semi-, -ish, on the ... side, a short time, a while.
鋏	はさみ, ハサミ	scissors, shears, clippers., hole punch.
何時でも	いつでも, なんどきでも	(at) any time, always, at all times, whenever.
嗽	うがい	gargling, rinsing one's mouth.
数	すう	several, a number of., number, numeral, figure., destiny, fate., law.
剃る	そる, する	to shave.
描く	えがく, かく	to draw, to paint, to sketch., to depict, to describe.
品	しな	article, item, thing, goods, stock., quality., flirtatiousness, coquetry.
方々	ほうぼう	here and there, this way and that way.
面	おもて, おも, も, もて	face., surface., mask (esp. a noh or kyogen mask).
面	めん	face., mask, face guard., (in kendo) striking the head., surface (esp. a geometrical surface)., page., aspect, facet, side., chamfer., counter for broad, flat objects, levels or stages, e.g. in a video game.
偖	さて	well, now, then.
有らゆる	あらゆる	all, every.
或いは	あるいは, あるは	or, possibly.
苛々	いらいら, イライラ	getting nervous, irritation.
得る	える	to get, to earn, to acquire, to procure, to gain, to secure, to attain, to obtain, to win., to understand, to comprehend., to receive something undesirable (e.g. a punishment), to get (ill)., (after the -masu stem of a verb) to be able to ..., can ....
陰	かげ	shade, shadow., other side, back, background.
可也	かなり	considerably, fairly, quite.
全て	すべて	everything, all, the whole., entirely, completely, wholly, all.
精々	せいぜい	at the most, at best, to the utmost, as much (far) as possible.
偶々	たまたま	casually, unexpectedly, accidentally, by chance.
吠える	ほえる	to bark, to bay, to howl, to bellow, to roar, to cry.
益々	ますます	increasingly, more and more, decreasingly (when declining), less and less.
寧ろ	むしろ	rather, better, instead.
一度に	いちどに	all at once.
生まれ	うまれ	birth, birthplace., born in (country, month, imperial era, zodiac year, etc.).
違いない	ちがいない	(phrase) sure, no mistaking it, for certain.
滅多に	めったに	rarely, seldom.
若しも	もしも	if.
轢く	ひく	to run somebody over (with vehicle), to knock someone down.
だが		but, however, (and) yet, nevertheless, still, for all that.
位	い	rank, place (e.g. first place)., decimal place., counter for ghosts.
注ぐ	つぐ	(usu. written as kana when referring to a solid) to pour (into a vessel), to fill, to dish out food or drink.
急に	きゅうに	swiftly, rapidly., suddenly, abruptly, immediately.
品	ひん	elegance, grace, refinement, class, dignity., article, item., counter for items (of food, etc.), counter for dishes or courses (at a restaurant).
日本	にほん, にっぽん	Japan.
お昼	おひる	lunch, noon.
持ち上げる	もちあげる	to elevate, to raise, to lift up., to flatter, to extol, to praise to the sky.
畑地	はたち	farmland.
行けない	いけない	wrong, not good, of no use., hopeless, past hope., must not do.
いらっしゃい		(used as a polite imperative) come, go, stay., welcome!.
がっかり		feel disappointed, dejected, lose heart, feel emotionally drained, feel let down.
きちんと		precisely, accurately, neatly.
きつい		intense, severe, hard., determined, forceful, formidable., strong., tight, close.
ぐっすり		sound asleep, fast asleep.
こんなに		so, like this, in this way.
さっぱり		feeling refreshed, feeling relieved., neat, trimmed., plain, simple., completely, entirely., not in the least (in sentence with negative verb), not at all., completely ignorant, not doing at all.
ざっと		roughly, in round numbers., cursorily, briefly.
凝乎と	じっと, じーっと, じーと, じいっと	motionlessly (e.g. stand, wait), (be) still., fixedly (e.g. gaze, stare), intently (e.g. listen, think)., patiently (endure), stoically., firmly (e.g. hold), restrained.
そっくり		all, altogether, entirely, just like, the spitting image of.
そっと		softly, gently, quietly, secretly.
たった		only, merely, but, no more than.
たっぷり		full, in plenty, ample.
だけど		however.
ちゃんと		diligently, seriously, earnestly, reliably, steadily, legitimately., perfectly, properly, exactly, orderly, punctually, regularly., sufficiently, satisfactorily., quickly.
ですから		so, therefore.
と		if, when., and., with., particle used for quoting (with speech, thoughts, etc.), quoting particle., promoted pawn (shogi)., indicates question (sentence end).
とんでも無い	とんでもない	unthinkable, unexpected, outrageous, offensive, terrible., absolutely not!, not at all!, far from it!, impossible!, preposterous!, what a thing to say!, no way!, bullshit., don't mention it, you're welcome.
どんなに		how, how much.
なんか		things like ..., or something like that ... (often derogatory).
のんびり		carefree, at leisure.
ぴったり		tightly, closely., exactly, precisely., suddenly (stopping)., perfectly (suited), ideally.
ぼんやり		dimly, faintly, indistinctly, vaguely., absentmindedly, vacantly, carelessly., idly, aimlessly., absence of mind, fool, blockhead, dunce.
まあ		just (e.g. "just wait here"), come now, now, now., tolerably, passably, moderately, reasonably, fairly, rather, somewhat., well..., I think..., it would seem..., you might say..., Hmmm, I guess so...., oh!, oh dear!, oh, my!, wow!, goodness gracious!, good heavens!.
オフィス		office.
カー		car.
キャプテン		captain.
グランド		large., gland., ground (e.g. land, electrical, base material of textiles, etc.).
ジーンズ		jeans.
バン		bun., van (caravan)., value-added network, VAN., bang.
パス		path., pass (e.g. skipping a move, passing an examination, ticket to allow entry, etc.)., pass.
マスター		to master, to learn., proprietor, manager, bar-owner., master (e.g. arts, science).
欧羅巴	ヨーロッパ	Europe.
不図	ふと	suddenly, casually, accidentally, incidentally, unexpectedly, unintentionally.
にっこり		smile sweetly, smile, grin.
も		too, also, in addition, as well, (not) either (in a negative sentence)., both A and B, A as well as B, neither A nor B (in a negative sentence)., even, as much as, as many as, as far as, as long as, no less than, no fewer than., even if, even though, although, in spite of., further, more, again, another, the other.
だって		after all, because., but., even., too, as well, also., they say, I hear, you mean.
これ等	これら	these.
麦酒	ばくしゅ	beer.
何時か	いつか	sometime, someday, one day, some time or other, the other day, in due course, in time.
周	しゅう	Zhou (dynasty of China), Chou., (geometric) perimeter., counter for laps or circuits.
男の人	おとこのひと	man.
付く	つく	to be attached, to be connected with, to adhere, to stick, to cling., to remain imprinted, to scar, to stain, to dye., to bear (fruit, interest, etc.)., to be acquired (of a habit, ability, etc.), to increase (of strength, etc.)., to take root., to accompany, to attend, to follow, to study with., to side with, to belong to., to possess, to haunt., to be lit, to be lighted., to be settled, to be resolved, to be decided., to be given (of a name, price, etc.)., to be sensed, to be perceived., to be lucky., (after -masu stems, onomatopoeic and mimetic words) to become (a state, condition, etc.).
分	ぶ	one-tenth, one percent (one-tenth of a wari), 3 mm (one-tenth of a sun), 2.4 mm (one-tenth of a mon, a traditional unit used to measure shoe sizes), 0.1 degree (one-tenth of a do, used to measure body temperature on any temperature scale)., one-quarter of a ryou (obsolete unit of currency)., thickness., advantageous circumstances., one-tenth of a monme of silver.
胼胝	たこ, べんち, へんち	callus, callosity, corn.
出端	では	chance of going out, opportunity (to succeed)., musical accompaniment for an actor going on stage.
ばったり		with a clash, with a thud, with a bang, with a flop, plump., unexpectedly (meeting someone)., suddenly (ending), abruptly (coming to a halt).
不	ふ	un-, non-, negative prefix.
館	かん	house, hall, building.
巻	かん	volume (of book), reel (of film).
感	かん	feeling, sensation, emotion, admiration, impression.
無	む	nothing, naught, nought, nil, zero., un-, non-.
お互い	おたがい	mutual, reciprocal, each other.
あんなに		to that extent, to that degree.
アッ		oh, ah.
ト		7th in a sequence denoted by the iroha system, 7th note in the diatonic scale (used in key names, etc.).
訳	やく	translation, version (e.g. "English version").
間	かん	interval, period of time., among, between, inter-.
はあ		yes, indeed, well., ha!., what?, huh?., sigh.
艘	そう	counter for (small) boats.
下	げ	lowness (of degree, value, etc.), inferiority., second volume (of two), third volume (of three).
下	しも	lower reaches (of a river)., bottom, lower part., lower half (of the body, esp. the privates), feces (faeces), urine, menses., end, far from the imperial palace (i.e. far from Kyoto, esp. of western Japan)., dirty (e.g. dirty jokes, etc.).
ノー		no.
税	ぜい	tax.
小	しょう	smallness, small item., short month (i.e. having fewer than 31 days)., elementary school., younger or inferior (of two items or people with the same name).
湖	こ	lake (in place names).
生	せい, しょう	life, living., I, me, myself.
氏	し	Mr., clan., he, him., counter for people.
後	ご	after.
小	こ	small, little, slight., slightly less than, just about., somewhat, somehow., minor (sometimes derogatory), petty.
けち		stinginess, miserliness, penny-pinching, cheesparing, miser, pinchpenny, skinflint, cheapskate, tightwad, niggard., shabby, cheap, mangy, poor., petty, narrow-minded, quibbling, mean-spirited., bad luck, ill omen, glitch.
無	ぶ	un-, non-., bad ..., poor ....
とん		tap, knock, bonk.
