上がる	あがる	to rise, to go up, to come up, to ascend, to be raised., to enter (esp. from outdoors), to come in, to go in., to enter (a school), to advance to the next grade., to get out (of water), to come ashore., to increase., to improve, to make progress., to be promoted, to advance., to be made (of profit, etc.)., to occur (esp. of a favourable result)., to be adequate (to cover expenses, etc.)., to be finished, to be done, to be over., (of rain) to stop, to lift., to stop (working properly), to cut out, to give out, to die., to win (in a card game, etc.)., to be arrested., to turn up (of evidence, etc.)., to be deep fried., to be spoken loudly., to get stage fright., to be offered (to the gods, etc.)., to go, to visit., to eat, to drink., to be listed (as a candidate)., to serve (in one's master's home)., (in Kyoto) to go north., (after the -masu stem of a verb) indicates completion.
音	おと, ね, おん	sound, noise, report., note (music)., fame., Chinese-derived character reading.
代わり	かわり	substitute, replacement, substituting, replacing., stand-in, proxy, alternate, deputy, relief, successor., compensation, exchange, return., second helping, another cup, seconds., upcoming program, upcoming programme.
受ける	うける	to receive, to get., to catch (e.g. a ball)., to be struck by (wind, waves, sunlight, etc.)., to sustain (damage), to incur (a loss), to suffer (an injury), to feel (influence)., to undergo (e.g. surgery), to take (a test), to accept (a challenge)., to be given (e.g. life, talent)., to follow, to succeed, to be descended from., to face (south, etc.)., to be modified by., to obtain (a pawned item, etc.) by paying a fee., to be well-received, to become popular, to go down well.
素晴らしい	すばらしい, すんばらしい	wonderful, splendid, magnificent.
工場	こうじょう, こうば	factory, plant, mill, workshop.
答え	こたえ, いらえ	response, reply, answer, solution.
漫画	まんが, マンガ	cartoon, comic, comic strip.
包む	くるむ, つつむ	to wrap up, to tuck in, to pack, to do up, to cover with, to dress in., to conceal, to hide, to be engulfed in, to be enveloped by.
久しぶり	ひさしぶり	a long time (since the last time), it's been a while (since I last saw, mailed, etc., you).
硬い	かたい	hard, solid, tough., stiff, tight, wooden, unpolished (e.g. writing)., strong, firm (not viscous or easily moved)., safe, steady, honest, steadfast., obstinate, stubborn., bookish, formal, stuffy.
大分	だいぶ, だいぶん	considerably, greatly, a lot.
引き出し	ひきだし	drawer., withdrawal, drawing out., variety of knowledge and experience useful for handling things impromptu.
見つかる	みつかる	to be found, to be discovered.
張る	はる	to stick, to paste, to affix, to link (e.g. in WWW forums)., to stretch, to spread, to strain, to tighten, to put up (tent)., to form (e.g. ice on a pond)., to fill, to swell., to stick out, to put, to slap., to be expensive., to become one tile away from completion (mahjong).
贈り物	おくりもの	present, gift.
乗り物	のりもの	vehicle.
柔らかい	やわらかい	soft, tender, limp.
増える	ふえる	to increase, to multiply.
引き出す	ひきだす	to pull out, to take out, to draw out, to withdraw.
安全	あんぜん	safety., security.
意見	いけん	opinion, view, comment.
運動	うんどう	exercise, physical training, work-out., appeal, campaign, drive, crusade, movement, lobbying., motion, movement.
会議	かいぎ	meeting, conference, session, assembly, council, convention, congress.
関係	かんけい	relation, relationship, connection., participation, involvement, concern., influence, effect., sexual relations, sexual relationship., related to ..., connected to ....
気	き	spirit, mind, heart., nature, disposition., motivation, intention., mood, feelings., atmosphere, essence.
技術	ぎじゅつ	art, craft, technique, technology, engineering, skill.
客	きゃく, かく	guest, visitor., customer, client, shopper, spectator, audience, tourist, sightseer, passenger.
教育	きょういく	training, education.
空港	くうこう	airport.
形	かたち, よう	form, shape, figure., visage.
経済	けいざい	economics, business, finance, economy.
計画	けいかく	plan, project, schedule, scheme, program, programme.
警察	けいさつ	police., police officer., police station.
研究	けんきゅう	study, research, investigation.
原因	げんいん	cause, origin, source.
光	ひかり	light.
高校	こうこう	senior high school, high school.
国際	こくさい	international.
最も	もっとも, もとも	most, extremely.
最近	さいきん	most recent, these days, right now, recently, nowadays.
最後	さいご	last, end, conclusion, latest, most recent., (after -tara form or -ta form followed by "ga") no sooner than, right after (often having negative consequences).
最初	さいしょ	beginning, outset, first, onset.
妻	つま	wife., garnish (esp. one served with sashimi)., embellishment.
産業	さんぎょう	industry.
子	こ	child., young (animal)., young woman, young geisha., offshoot., interest., new shares., player who is not a dealer (in cards, mahjong, etc.)., -er (often of young women).
市民	しみん	citizen, citizenry, public., city inhabitant, townspeople., bourgeoisie, middle class.
旨い	うまい	skillful, clever, expert, wise, successful., delicious, appetizing, appetising., fortunate, splendid, promising.
試合	しあい	match, game, bout, contest.
事故	じこ, ことゆえ	accident, incident, trouble., circumstances, reasons.
事務所	じむしょ	office.
時代	じだい	period, epoch, era, age., the times, those days., oldness, ancientness, antiquity., antique, period piece.
自由	じゆう	freedom, liberty, as it pleases you.
社会	しゃかい	society, public, community, the world., social studies.
社長	しゃちょう	company president, manager, director.
女性	じょせい, にょしょう	woman, female., feminine gender.
将来	しょうらい	future (usually near), prospects.
場所	ばしょ	place, location, spot, position., room, space., basho, wrestling tournament.
人口	じんこう	population., common talk.
世界	せかい	the world, society, the universe., sphere, circle, world., renowned, world-famous, well-known outside of Japan., realm governed by one Buddha, space.
政治	せいじ	politics, government.
生活	せいかつ	living, life (one's daily existence), livelihood.
生産	せいさん	production, manufacture.
戦争	せんそう	war.
男性	だんせい	man, male., masculine gender.
特に	とくに	particularly, especially.
特別	とくべつ	special.
反対	はんたい	opposition, resistance, antagonism, hostility, contrast, objection, dissension, reverse, opposite, vice versa.
番組	ばんぐみ	program (e.g. TV), programme.
必要	ひつよう	necessary, needed, essential, indispensable., necessity, need, requirement.
夫	おっと	husband.
部長	ぶちょう	head (chief, director) of a section or department., head of a (school) club, head of a (school) team.
文化	ぶんか	culture, civilization, civilisation., Bunka era (1804.2.11-1818.4.22).
放送	ほうそう	broadcast, broadcasting.
貿易	ぼうえき	trade (foreign).
輸出	ゆしゅつ, しゅしゅつ	export., efferent (medical).
輸入	ゆにゅう, しゅにゅう	importation, import, introduction.
予定	よてい	plans, arrangement, schedule, program, programme, expectation, estimate.
理由	りゆう, わけ	reason, pretext, motive.
歴史	れきし	history.
行う	おこなう	to perform, to do, to conduct oneself, to carry out.
気持ち	きもち	feeling, sensation, mood., preparedness, readiness, attitude., thanks, solicitude, sympathy., just a little, somewhat, slightly.
以内	いない	within, inside of, less than.
医学	いがく	medical science, medicine.
運転	うんてん	operation (of a machine, etc.), operating, running, run., driving., working (capital, etc.).
科学	かがく	science.
課長	かちょう	section manager, section chief.
会場	かいじょう	assembly hall, meeting place, venue, grounds.
学部	がくぶ	department of a university., undergraduate (course, program, etc.).
簡単	かんたん	simple, easy, uncomplicated., brief, quick, light.
危険	きけん	danger, peril, hazard., dangerous, hazardous.
機会	きかい	chance, opportunity.
競争	きょうそう	competition, contest., to compete.
経験	けいけん	experience.
交通	こうつう	traffic, transportation, communication, exchange (of ideas, etc.), intercourse.
工業	こうぎょう	(manufacturing) industry.
今度	こんど	now, this time, next time, another time.
試験	しけん	examination, test, study, trial, experiment.
寺	てら	temple (Buddhist).
十分	じゅうぶん	plenty, enough, sufficient, satisfactory, adequate., division into ten., perfectly, thoroughly, fully, in full.
準備	じゅんび	preparation, setup, arrangements, provision, reserve.
森	もり	forest., shrine grove.
親	おや	parent, parents., dealer (in cards, mahjong, etc.)., founder., (pet) owner.
昔	むかし	olden days, former.
説明	せつめい	explanation, exposition.
専門	せんもん	speciality, specialty, subject of study, expert.
相談	そうだん	consultation, discussion.
地震	じしん, ない, なえ, じぶるい	earthquake.
島	しま	island., territory (of a prostitute, organized crime gang, etc.), turf.
彼ら	かれら	they (usually male), them.
彼女	かのじょ	she, her., her., girlfriend, sweetheart.
比べる	くらべる	to compare, to make a comparison., to compete, to vie.
普通	ふつう	general, ordinary, usual., normally, generally, usually., train that stops at every station.
文学	ぶんがく	literature.
壁	かべ, へき	wall, partition., barrier, obstacle., Chinese "Wall" constellation (one of the 28 mansions).
法律	ほうりつ	law.
夢	ゆめ	dream.
娘	むすめ	(my) daughter., girl (i.e. a young, unmarried woman).
利用	りよう	use, utilization, utilisation, application.
林	はやし	woods, forest, copse, thicket.
例えば	たとえば	for example, e.g..
連絡	れんらく	to contact, to get in touch., contacting, getting in touch, communication, call, message., connection, coordination, junction., intercalary, intercalaris, internuncial.
途中	とちゅう	on the way, en route., in the middle of, midway.
選ぶ	えらぶ	to choose, to select.
思う	おもう	to think, to consider, to believe., to think (of doing), to plan (to do)., to judge, to assess, to regard., to imagine, to suppose, to dream., to expect, to look forward to., to feel, to desire, to want., to recall, to remember.
確か	たしか	sure, certain, positive, definite., reliable, trustworthy, safe, sound, firm, accurate, correct, exact., If I'm not mistaken, If I remember correctly, If I remember rightly.
気分	きぶん	feeling, mood.
急	きゅう	urgent, sudden, abrupt., sharp, steep, precipitous., rapid, swift, fast., emergency, crisis., hurrying, haste., (in gagaku or noh) end of a song.
空気	くうき	air, atmosphere., mood, situation., someone with no presence, someone who doesn't stand out at all.
決して	けっして, けして	never, by no means, not in the least, in no way.
血	ち	blood, consanguinity.
校長	こうちょう	principal, headmaster.
高校生	こうこうせい	senior high school student.
残念	ざんねん	deplorable, bad luck, regret, disappointment.
住所	じゅうしょ	address (e.g. of house), residence, domicile.
出席	しゅっせき	attendance, presence, appearance., to attend, to be present, to appear.
小学校	しょうがっこう	primary school, elementary school, grade school.
小説	しょうせつ	novel, (short) story.
食事	しょくじ	meal., to eat.
息子	むすこ, そく	son., penis.
卒業	そつぎょう	graduation, completion (e.g. of a course)., outgrowing something, moving on.
美術館	びじゅつかん	art gallery, art museum.
必ず	かならず	always, without exception, necessarily, certainly, without fail, positively, invariably.
複雑	ふくざつ	complex, complicated, mixed (feelings).
変わる	かわる	to change, to be transformed, to be altered, to vary., to move to., to be different, to be uncommon, to be unusual.
味	あじ	flavor, flavour, taste., charm, style., experience., smart, clever, witty, strange.
首	くび, クビ	neck., head., dismissal, discharge, firing (from a job).
割合	わりあい	rate, ratio, percentage, proportion., comparatively., contrary to expectations.
以下	いか, いげ	not exceeding, and downward, ... and below., below (e.g. standard), under (e.g. a level)., the below-mentioned, the following, the rest.
運転手	うんてんしゅ	driver, chauffeur.
会話	かいわ	conversation.
楽しみ	たのしみ	enjoyment, pleasure, diversion, amusement, hobby., anticipation, looking forward to.
看護婦	かんごふ	(female) nurse.
季節	きせつ	season.
興味	きょうみ	interest (in something), curiosity (about something), zest (for).
港	みなと	harbour, harbor, port.
郊外	こうがい	suburb, outskirts.
失敗	しっぱい	failure, mistake, blunder.
心配	しんぱい	worry, concern, anxiety., care, help, aid, assistance.
生きる	いきる	to live, to exist., to make a living, to subsist., to be in effect, to be in use, to function., to come to life, to be enlivened., to be safe (in baseball, go, etc.).
席	せき	seat., location (of a gathering, etc.), place., position, post.
線	せん	line, stripe, stria., line (e.g. telephone line), wire., ray (e.g. X-ray), beam., line (e.g. of a railroad), track, route, lane., outline, contours, form., level., division., line (of action), position, approach, policy, principle., impression one leaves, air one gives off.
中学校	ちゅうがっこう	junior high school, middle school, lower secondary school.
注意	ちゅうい	caution, being careful, attention (heed), warning, advice.
入院	にゅういん	hospitalization, hospitalisation.
入学	にゅうがく	entry to school or university, matriculation, enrolment (in university, etc.).
遊び	あそび	playing., play (margin between on and off, gap before pressing button or lever has an effect).
葉	は	leaf.
格好	かっこう, かっこ, カッコ	shape, form, figure, posture, pose., appearance., state, situation., suitable, fit, reasonable., about.
仕方	しかた	way, method, means, resource, course.
台風	たいふう	typhoon, hurricane.
値段	ねだん	price, cost.
船	ふね	ship, boat, watercraft, vessel, steamship., tank, tub, vat, trough., counter for boat-shaped containers (e.g. of sashimi).
安心	あんしん	relief, peace of mind.
海岸	かいがん	coast, beach.
間	あいだ, あわい	space (between), gap, interval, distance., time (between), pause, break., span (temporal or spatial), stretch, period (while)., relationship (between, among)., members (within, among).
教会	きょうかい	church.
故障	こしょう	breakdown, failure, fault, accident, out of order., damage, hurt., objection, protest.
公務員	こうむいん	government worker, public servant, civil servant.
枝	えだ	branch, bow, bough, twig, limb.
趣味	しゅみ	hobby, pastime., tastes, preference, liking.
柔道	じゅうどう	judo.
出発	しゅっぱつ	departure.
招待	しょうたい, しょうだい	invitation.
紹介	しょうかい	introduction, referral.
新聞社	しんぶんしゃ	newspaper company.
神社	じんじゃ	Shinto shrine.
人形	にんぎょう	doll, puppet, figure.
世話	せわ	looking after, help, aid, assistance.
是非	ぜひ	certainly, without fail., right and wrong, pros and cons.
星	ほし	star, any light-emitting (or reflecting) heavenly body (except for the sun and the moon)., suspect (police slang).
盛ん	さかん	popular., prosperous., enthusiastic., energetic, vigorous.
先輩	せんぱい	senior (at work or school), superior, elder, older graduate, progenitor, old-timer.
駐車場	ちゅうしゃじょう	parking lot, parking place.
点	てん	spot, mark., point, dot., mark (e.g. in exam), score, points., comma., aspect, matter, respect., counter for goods, items, articles of clothing, works of art, etc..
熱	ねつ	heat., fever, temperature., zeal, passion, enthusiasm., mania, craze, rage.
熱心	ねっしん	zeal, enthusiasm.
無理	むり	unreasonable, unnatural, unjustifiable., impossible., forcible, forced, compulsory., excessive (work, etc.), immoderate.
約束	やくそく	promise, agreement, arrangement, one's word, contract, pact, appointment, engagement, date., convention, rule., destiny, fate.
用意	ようい	preparation, arrangements, provision, getting ready, laying out (e.g. a meal).
腕	うで	arm., skill.
終わり	おわり	the end.
周り	まわり	circumference, girth., surroundings, neighbourhood, neighborhood, vicinity.
一生懸命	いっしょうけんめい	very hard, with utmost effort, with all one's might, for dear life.
運ぶ	はこぶ	to carry, to transport, to move, to convey., to come, to go., to wield (a tool, etc.), to use., to go (well, etc.), to proceed, to progress.
雲	くも	cloud.
規則	きそく	rules, regulations, conventions.
鏡	かがみ	mirror, looking-glass., barrel head.
近所	きんじょ	neighbourhood, neighborhood.
砂	すな, すなご, いさご	sand, grit., gold dust, silver dust.
指	ゆび, および, おゆび	finger, toe, digit.
習慣	しゅうかん	custom, habit, manners.
水道	すいどう	water service, water supply.
正月	しょうがつ	New Year, New Year's Day, the first month, January.
赤ちゃん	あかちゃん	baby, infant.
草	くさ	grass, weed, herb, thatch., not genuine, substandard.
送る	おくる	to send (a thing), to dispatch, to despatch, to transmit., to take or escort (a person somewhere), to see off (a person)., to bid farewell (to the departed), to bury., to spend (time), to live one's life., to pass (down the line)., to affix okurigana.
打つ	うつ	to hit, to strike, to knock, to beat, to punch, to slap, to tap, to bang, to clap, to pound., to strike (noon, etc.), to sound (cymbals, etc.), to beat (a drum, etc.)., to beat (rhythmically, e.g. pulse, waves, etc.)., to move, to impress, to touch., to drive in, to hammer in, to put in, to inject., to type, to send, to transmit., to insert, to write in, to mark., to make (noodles, etc.), to prepare., to till (soil)., to sprinkle, to throw, to cast., to do, to carry out, to play, to perform, to engage in (gambling, etc.)., to pay (a deposit, etc.)., to visit (on a pilgrimage)., to line (a coat)., to bind (a criminal).
虫	むし	insect, bug, cricket, moth, worm.
適当	てきとう	suitable, proper, appropriate, adequate, fit., noncommittal, vague, equivocal, unserious, irresponsible.
湯	ゆ	hot water., hot bath, hot spring., molten iron.
髪	かみ	hair (on the head).
表	おもて	surface., face (i.e. the visible side of an object)., front (of a building, etc.), obverse side (i.e. "head") of a coin., outside, exterior., appearance., public., first half (of an innings), top (of an inning)., cover (for tatami mats, etc.)., foreground.
訪ねる	たずねる	to visit.
翻訳	ほんやく	translation., de-encryption, deciphering., rendering.
毛	け	hair, fur.
予約	よやく	reservation, appointment, booking, advance order., contract, subscription, pledge.
売り場	うりば	place where things are sold, point of sale, POS, sales floor, counter (in shop).
案内	あんない	information, guidance, leading., to guide, to show (around), to conduct.
下げる	さげる	to hang, to suspend, to wear (e.g. decoration)., to lower, to reduce, to bring down., to demote, to move back, to pull back., to clear (plates), to remove (food, etc. from table or altar).
帰り	かえり	return, coming back.
糸	いと	thread, yarn, string.
集める	あつめる	to collect, to assemble, to gather.
水泳	すいえい	swimming.
店員	てんいん	shop assistant, employee, clerk, salesperson.
都合	つごう	circumstances, condition, convenience., to arrange, to manage., to lend money, to raise money., in all, in total, all told.
動物園	どうぶつえん	zoo, zoological gardens.
道具	どうぐ	tool, implement, instrument, utensil, apparatus, device., means.
日記	にっき	diary, journal.
背中	せなか	back (of body).
僕	ぼく	I, me., you (used addressing young children)., manservant.
両方	りょうほう	both, both sides, both parties.
具合	ぐあい	condition, state, manner, health.
湖	みずうみ	lake.
講義	こうぎ	lecture.
合う	あう, おう	to come together, to merge, to unite, to meet., to fit, to match, to suit, to agree with, to be correct., to be profitable, to be equitable., (after the -masu stem of a verb) to do ... to each other, to do ... together.
事	こと, こん	thing, matter., incident, occurrence, event, something serious, trouble, crisis., circumstances, situation, state of affairs., work, business, affair., after an inflectable word, creates a noun phrase indicating something the speaker does not feel close to., nominalizing suffix., pretending to ..., playing make-believe ...., alias, aka, nickname, alternative name, also known as.
西洋	せいよう	the west, Western countries.
大事	だいじ, おおごと	important, valuable, serious matter.
展覧会	てんらんかい	exhibition.
内	うち	inside, within., while., among, amongst, between., we (referring to one's in-group, i.e. company, etc.), our., my spouse., I (primarily used by women and children), me.
美しい	うつくしい	beautiful, lovely.
返事	へんじ	reply, answer, response.
踊り	おどり	dance.
昼間	ひるま, ちゅうかん	daytime, during the day, time from sunrise until sunset, diurnal period.
真ん中	まんなか, まなか	middle, centre, center, mid-way.
探す	さがす	to search (for something desired, needed), to look for., to search (for something lost), to seek (a suspect in a crime).
為	ため	good, advantage, benefit, welfare., sake, purpose, objective, aim., consequence, result, effect., affecting, regarding, concerning.
金持ち	かねもち	rich person.
区	く	ward, district, section.
隅	すみ, すま	corner, nook, recess., downstage right (on a noh stage).
細かい	こまかい	small., fine, minute., minor, trivial., sensitive, attentive.
坂	さか	slope, hill.
場合	ばあい	case, situation.
数学	すうがく	mathematics, arithmetic.
祖父	そふ, じじ, じい, おおじ, おじ, そぶ	grandfather., old man., kyogen mask used for the role of an old man.
着物	きもの	clothing, clothes., kimono (or other trad. Japanese clothing).
注射	ちゅうしゃ	injection.
丁寧	ていねい	polite, courteous, careful, care, kind, close, thorough, conscientious.
田舎	いなか	rural area, countryside, the sticks., hometown.
盗む	ぬすむ	to steal.
倍	ばい	twice, double., times, -fold.
旅館	りょかん	Japanese hotel, inn, ryokan.
受付	うけつけ	reception (desk), information desk., receipt, acceptance.
屋上	おくじょう	rooftop.
火事	かじ	fire, conflagration.
考える	かんがえる	to think about, to take into consideration., to ponder, to reflect, to try to come at a conclusion, to think over (something)., to intend, to decide (to do), to plan., to come up with, to devise, to scheme., to predict, to anticipate, to expect., to suspect, to doubt., to consider (somebody to be something), to look on.
講堂	こうどう	auditorium, lecture hall.
祖母	そぼ, ばば, おおば, おば, うば	grandmother.
地理	ちり	geography.
倒れる	たおれる	to fall, to collapse, to drop, to fall senseless., to be forced to bed (by illness, etc.)., to die., to go bankrupt, to be ruined, to have a bad debt., to be defeated (in a game)., to fall (of governments, dictators, etc.).
特急	とっきゅう	limited express (train, faster than an express)., great hurry.
布団	ふとん	futon (quilted Japanese-style mattress laid out on the floor)., round cushion used for Zen meditation (traditionally made of woven bulrush leaves).
落ちる	おちる	to fall down, to drop, to fall (e.g. rain), to sink (e.g. sun or moon), to fall onto (e.g. light or one's gaze), to be used in a certain place (e.g. money)., to be omitted, to be missing., to decrease, to sink., to fail (e.g. exam or class), to lose (contest, election, etc.)., to crash, to degenerate, to degrade, to fall behind., to become indecent (of a conversation)., to be ruined, to go under., to fade, to come out (e.g. a stain), to come off (e.g. makeup), to be removed (e.g. illness, possessing spirit, name on a list)., to fall (into someone's hands), to become someone's possession., to fall (into a trap), to fall (for a trick)., to give in, to give up, to confess, to flee., to fall, to be defeated, to surrender., to come to (in the end), to end in., to fall (in love, asleep, etc.)., to swoon (judo)., to consent, to understand., to crash, to freeze., to die., to move to the depths.
辞典	じてん, ことばてん	dictionary.
下着	したぎ	underwear.
苦い	にがい	bitter.
承知	しょうち	knowledge, awareness., consent, acceptance, assent, admitting, compliance, agreement, acknowledgment, acknowledgement., forgiving, pardoning, excusing.
棚	たな	shelf, shelves, ledge, rack., trellis.
留守	るす	absence, being away from home., house-sitting, house-sitter., being left unattended to (of one's studies, etc.), neglecting.
以上	いじょう	not less than, ... and more, ... and upwards., beyond ... (e.g. one's means), further (e.g. nothing further to say), more than ... (e.g. cannot pay more than that)., above-mentioned, foregoing., since ..., seeing that ...., this is all, that is the end, the end.
花見	はなみ	cherry blossom viewing, flower viewing.
絹	きぬ	silk.
消しゴム	けしゴム	eraser, India rubber.
畳	たたみ	tatami mat, Japanese straw floor coverings.
飾る	かざる	to decorate, to ornament, to adorn.
退院	たいいん	leaving hospital, discharge from hospital.
暮れる	くれる	to get dark., to end, to come to an end, to close, to run out., to be sunk (e.g. in despair), to be lost.
冷房	れいぼう	cooling, air-conditioning.
起こす	おこす	to raise, to cause, to wake someone.
大体	だいたい	general, substantially, outline, main point, approximately, about.
ご存じ	ごぞんじ	knowing., (an) acquaintance.
景色	けしき, けいしょく	scenery, scene, landscape.
見物	けんぶつ	sightseeing, watching, viewing., sightseer, watcher, spectator.
構う	かまう	to mind, to care about, to be concerned about., to care for, to look after., to prepare for., to interfere with, to meddle in., to tease.
指輪	ゆびわ	(finger) ring.
邪魔	じゃま	hindrance, obstacle, nuisance., to visit (somebody's home)., demon who hinders Buddhist training, demon who obstructs sentient beings from maintaining moral behaviour.
赤ん坊	あかんぼう, あかんぼ	baby, infant.
騒ぐ	さわぐ	to make noise, to make racket, to be noisy., to rustle, to swoosh., to make merry., to clamor, to clamour, to make a fuss, to kick up a fuss., to lose one's cool, to panic, to act flustered., to feel tense, to be uneasy, to be excited.
通る	とおる	to go by, to go past, to go along, to travel along, to pass through, to use (a road), to take (a route), to go via, to go by way of., to run (between), to operate (between), to connect., to go indoors, to go into a room, to be admitted, to be shown in, to be ushered in, to come in., to penetrate, to pierce, to skewer, to go through, to come through., to permeate, to soak into, to spread throughout., to carry (e.g. of a voice), to reach far., to be passed on (e.g. of a customer's order to the kitchen), to be relayed, to be conveyed., to pass (a test, a bill in the House, etc.), to be approved, to be accepted., to go by (a name), to be known as, to be accepted as, to have a reputation for., to be coherent, to be logical, to be reasonable, to be comprehensible, to be understandable, to make sense., to get across (e.g. of one's point), to be understood., to be straight (e.g. wood grain)., to do ... completely, to do ... thoroughly.
漬ける	つける	to soak, to seep, to dip in., to pickle.
電報	でんぽう	telegram.
飛行場	ひこうじょう	airfield, airport.
品物	しなもの	goods, article, thing.
優しい	やさしい	tender, kind, gentle, graceful, affectionate, amiable.
決まる	きまる	to be decided, to be settled., to look good in (clothes).
一杯	いっぱい	amount necessary to fill a container (e.g. cupful, spoonful, etc.), drink (usu. alcoholic)., full., one squid, octopus, crab, etc., one boat., fully, to capacity., a lot, much., all of ..., the entire ....
喜ぶ	よろこぶ	to be delighted, to be glad, to be pleased., to congratulate., to gratefully accept.
高等学校	こうとうがっこう	senior high school, high school.
思い出す	おもいだす	to recall, to remember, to recollect.
支度	したく	preparation, arrangements.
親切	しんせつ	kindness, gentleness.
暖房	だんぼう	heating.
逃げる	にげる	to escape, to run away.
変	へん	strange, odd, peculiar, weird, curious, queer, eccentric, funny, suspicious, fishy., unexpected., change., incident, disturbance, disaster, accident., flat (music).
又は	または	or, otherwise.
泥棒	どろぼう	thief, burglar, robber, theft.
楽しむ	たのしむ	to enjoy (oneself).
見える	みえる	to be seen, to be in sight., to look, to seem, to appear., to come.
全然	ぜんぜん	not at all (with neg. verb)., wholly, entirely, completely.
連れる	つれる	to lead, to take (a person).
下宿	げしゅく	boarding, lodging, boarding house.
始める	はじめる	to start, to begin, to commence, to initiate, to originate., to open (e.g. a store), to start up, to establish (business. etc.)., to start ..., to begin to ....
手袋	てぶくろ	glove, mitten, mitt.
申し上げる	もうしあげる	to say, to tell, to state, to express, to offer, to extend (greetings, congratulations, etc.)., to do.
発音	はつおん	pronunciation.
落とす	おとす	to drop, to lose, to let fall, to shed (light), to cast (one's gaze), to pour in (liquid), to leave behind., to clean off (dirt, makeup, paint, etc.), to remove (e.g. stains or facial hair), to lose, to spend money at a certain place, to omit, to leave out, to secretly let escape., to lose (a match), to reject (an applicant), to fail (a course), to defeat (in an election)., to lower (e.g. shoulders or voice), to lessen (e.g. production or body weight), to worsen (quality), to reduce (e.g. rank or popularity), to speak badly of, to make light of, to fall into straitened circumstances., to fall into (e.g. a dilemma or sin), to make one's own, to have one's bid accepted, to force surrender, to take (e.g. an enemy camp or castle), to forcefully convince, to press for a confession, to deal with., to download, to copy from a computer to another medium., to make someone swoon (judo)., to finish a story (e.g. with the punch line)., to finish (a period, e.g. of fasting).
引っ越す	ひっこす, ひきこす	to move (house), to change residence.
下さる	くださる	to give, to confer, to bestow., to kindly do for one, to oblige, to favour, to favor.
厳しい	きびしい, いかめしい	severe, strict, rigid, unsparing, relentless., stern, austere, grave, solemn, majestic., intense (cold), harsh.
今夜	こんや	this evening, tonight.
残る	のこる	to remain, to be left.
出来るだけ	できるだけ	as much as one can, as much as possible, if at all possible.
小鳥	ことり	small bird, songbird., birdie, dickeybird, dickybird.
昼休み	ひるやすみ	lunch break, noon recess, noon rest period.
遠慮	えんりょ	reserve, constraint, restraint, modesty, diffidence, hesitation, holding back, discretion, tact, thoughtfulness., declining, refraining., forethought, foresight.
壊す	こわす	to break, to destroy, to demolish., to wreck, to ruin, to spoil, to damage., to break (a bill, etc.).
汽車	きしゃ	train (sometimes specifically a steam train).
踏む	ふむ	to step on, to tread on., to experience, to undergo., to estimate, to value, to appraise., to rhyme., to follow (rules, morals, principles, etc.).
居る	おる	to be (animate), to be, to exist., (after the -te form of a verb) verb indicating continuing action or state (i.e. to be ..ing)., (after -masu base of verb) indicates contempt or disdain for another's actions.
怖い	こわい	scary, frightening, eerie, dreadful., (I'm) afraid.
家内	かない, やうち	(my) wife., inside the home, one's family.
間に合う	まにあう	to be in time for., to serve (suit, meet) the purpose, to be good enough, to be enough.
急行	きゅうこう	moving at high speed., express (e.g. train that bypasses many stations).
集まる	あつまる	to gather, to collect, to assemble.
通う	かよう	to go back and forth, to ply between., to commute, to attend (school, church, etc.).
怒る	おこる, いかる	to get angry, to get mad., to tell someone off, to scold., to be angular, to be square.
お嬢さん	おじょうさん	daughter., young lady.
壊れる	こわれる	to be broken, to break., to fall through, to come to nothing.
申す	もうす	to say, to be called., to do.
払う	はらう	to pay (e.g. money, a bill, one's taxes, etc.)., to brush, to wipe, to clear away, to dust off, to prune away branches., to drive away (e.g. one's competitors), to sweep out.
嘘	うそ	lie, falsehood, incorrect fact., Really!, Unbelievable!, No way!.
玩具	おもちゃ, がんぐ, オモチャ	toy, plaything.
急ぐ	いそぐ	to hurry, to rush, to hasten, to make something happen sooner.
決める	きめる	to decide, to choose, to determine, to make up one's mind, to resolve, to set one's heart on, to settle, to arrange, to set, to appoint, to fix., to clinch (a victory), to decide (the outcome of a match)., to persist in doing, to go through with., to always do, to have made a habit of., to take for granted, to assume., to dress up, to dress to kill, to dress to the nines., to carry out successfully (a move in sports, a pose in dance, etc.), to succeed in doing., to immobilize with a double-arm lock (in sumo, judo, etc.)., to eat or drink something, to take illegal drugs.
笑う	わらう	to laugh., to smile., to sneer, to ridicule., to be dumbfounded, to be flabbergasted.
不便	ふべん	inconvenience, inexpediency, unhandiness.
文法	ぶんぽう	grammar, syntax.
木綿	もめん, きわた	cotton (material)., red silk-cotton tree (Bombax ceiba).
訳	わけ	conclusion from reasoning, judgement or calculation based on something read or heard, reason, cause, meaning, circumstances, situation.
頑張る	がんばる	to persevere, to persist, to keep at it, to hang on, to hold out, to do one's best., to insist that, to stick to (one's opinion)., to remain in a place, to stick to one's post, to refuse to budge.
深い	ふかい	deep., profound., dense, thick., close (relationship)., intense, strong., late.
沸かす	わかす	to boil, to heat., to excite.
役に立つ	やくにたつ	to be helpful, to be useful.
乗り換える	のりかえる	to transfer (trains), to change (bus, train)., to change one's mind, to move on to (e.g. a new love interest), to change methods, to change one's way of thinking.
向かう	むかう	to face., to go towards.
別れる	わかれる	to be divided, to part from, to separate, to bid farewell.
挨拶	あいさつ	greeting, greetings, salutation, salute, polite set phrase used when meeting or parting from somebody., polite set phrase used to express apology, sympathy, congratulations, etc.., speech (congratulatory or appreciative), address., reply, response., revenge, retaliation., a fine thing to say (used as part of a sarcastic response to a rude remark)., dialoging (with another Zen practitioner to ascertain their level of enlightenment).
下がる	さがる	to hang down, to abate, to retire, to fall, to step back.
迎える	むかえる	to go out to meet., to receive, to welcome, to greet, to salute, to hail, to reach, to approach, to enter (a phase, era, etc.)., to accept (e.g. as a member of a group or family)., to call for, to summon, to invite., to approach (a certain time, a point in one's life, etc.).
進む	すすむ	to advance, to go forward., to precede, to go ahead (of)., to make progress, to improve., to deepen, to heighten., to be fast (of a clock), to be ahead., to do of one's own free will.
正しい	ただしい	right, just, correct, righteous, honest, truthful, proper, straightforward, perfect.
駄目	だめ, ダメ	no good, not serving its purpose, useless, broken., hopeless, wasted, in vain, purposeless., cannot, must not, not allowed.
大抵	たいてい	mostly, ordinarily, usually, generally., probably., most, almost all., ordinary., proper, appropriate, moderate.
致す	いたす	to do.
電灯	でんとう	electric light.
冷える	ひえる	to grow cold (from room temperature, e.g. in refrigerator), to get chilly, to cool down.
写す	うつす	to transcribe, to duplicate, to reproduce, to imitate, to trace., to describe., to film, to picture, to photograph.
治る	なおる	to be cured, to get well, to be healed., to get mended, to be repaired, to be fixed.
けど		but, however, although.
コンピュータ		computer.
レポート		report, paper.
死	し	death, decease.
押し入れ	おしいれ	closet.
見付ける	みつける, みっける	to discover, to find (e.g. an error in a book), to come across, to detect, to spot., to locate, to find (e.g. something missing), to find fault., to be used to seeing, to be familiar with.
一度	いちど, ひとたび	once, one time, on one occasion., temporarily, for a moment., one degree, one tone, one musical interval.
治す	なおす	to cure, to heal., to fix, to correct, to repair., to do over again (after -masu base of verb)., to replace, to put back as it was., to convert (into a different state), to transform.
裏	うら	bottom (or another side that is hidden from view), undersurface, opposite side, reverse side., rear, back, behind (the house)., lining, inside., out of sight, behind the scenes., proof., opposite (of a prediction, common sense, etc.)., inverse (of a hypothesis, etc.)., bottom (of an inning), last half (of an inning).
可笑しい	おかしい	funny, amusing, comical, laughable, ridiculous., strange, odd, funny, peculiar, weird, unusual, eccentric., improper, unsuitable, unbecoming., suspicious.
二階建て	にかいだて	two-storied building.
会議室	かいぎしつ	conference room, council room.
研究室	けんきゅうしつ	laboratory., seminar room., professor's office.
食料品	しょくりょうひん	foodstuff, groceries.
匂い	におい	odour, odor, scent, smell, stench., aura, whiff, smacks of ..., sense, flavour, flavor.
就いて	ついて	about, concerning, as to, regarding.
伊達	だて	elegance, dandyism, sophistication, having style., affectation, showing off, putting on an air, appearances, just for show.
込む	こむ	to be crowded, to be packed., to be complex., to go into, to put into, to remain (seated), to be plunged into (silence), to do thoroughly., to do intently., to continue in the same state.
取り替える	とりかえる	to exchange, to replace.
用事	ようじ	tasks, things to do, errand, business (to take care of), affairs, engagement.
聞こえる	きこえる	to be heard, to be audible., to be said to be, to be reputed.
以外	いがい	with the exception of, excepting.
汚れる	よごれる	to get dirty, to become dirty., to become sullied, to become corrupted, to lose one's chastity.
尋ねる	たずねる	to ask, to enquire, to inquire., to search, to look for, to look into, to investigate.
程	ほど	degree, extent, bounds, limit., indicates approx. amount or maximum, upper limit.
塗る	ぬる	to paint, to plaster, to lacquer, to varnish, to spread, to smear.
光る	ひかる	to shine, to glitter, to be bright.
勝つ	かつ	to win, to gain victory.
恥ずかしい	はずかしい	shy, ashamed, embarrassed., disgraceful, shameful.
滑る	すべる	to glide, to slide (e.g. on skis), to slip., to fail (an examination), to bomb (when telling a joke)., to drop, to go down, to come down, to fall (e.g. in status).
似る	にる	to resemble, to look like, to take after., to be similar (in status, condition, etc.), to be close, to be alike, to be like.
泊まる	とまる	to stay at (e.g. hotel)., to be docked, to be berthed, to be moored.
負ける	まける	to lose, to be defeated., to succumb, to give in, to surrender, to yield., to be inferior to., to break out in a rash due to (e.g. lacquer, shaving, etc.)., to reduce the price, to lower the price, to give a discount on.
随分	ずいぶん	very, extremely, surprisingly, considerably., contemptible, reprehensible.
眠い	ねむい	sleepy, drowsy, somnolent.
間違える	まちがえる	to make a mistake (in), to commit an error (e.g. in calculation)., to confuse, to mistake something for something else.
失礼	しつれい, しつらい, しちらい	discourtesy, impoliteness., Excuse me, Goodbye., to leave., to be rude.
拝見	はいけん	seeing, look at.
差し上げる	さしあげる	to give, to offer., to lift up, to hold up, to raise.
歯医者	はいしゃ	dentist.
謝る	あやまる	to apologize, to apologise.
味噌	みそ	miso, fermented condiment usu. made from soybeans., innards (from crabs, shrimps, etc.) resembling miso., key (main) point, good part (of something)., weakling, weak person.
等々	とうとう	and so on, at last, finally, after all.
喉	のど, のんど, のみと, のみど	throat., singing voice.
珍しい	めずらしい	unusual, rare, curious., new, novel., fine (e.g. gift).
忘れ物	わすれもの	lost article, something forgotten.
寂しい	さびしい, さみしい	lonely, lonesome, solitary, desolate.
過ぎる	すぎる	to pass through, to pass by, to go beyond., to pass (i.e. of time), to elapse., to have expired, to have ended, to be over., to exceed, to surpass, to be above., to be no more than ...., to be excessive, to be too much, to be too ....
変える	かえる	to change, to alter, to transform, to convert, to turn, to vary., to reform, to revise, to amend.
参る	まいる	to go, to come, to call., to be defeated, to collapse, to die., to be annoyed, to be nonplussed., to be madly in love., to visit (shrine, grave).
積もり	つもり	intention, plan., conviction, belief.
釣る	つる	to fish, to angle, to catch., to lure in, to tempt, to attract, to entice, to allure.
悲しい	かなしい	sad, sorrowful.
捕まえる	つかまえる	to catch, to arrest, to seize.
噛む	かむ	to bite, to chew, to gnaw., to crash against (e.g. of waves), to break onto (shore)., to engage (of cogs, zippers, etc.), to mesh, to fit together., to be involved in., to fumble one's words (during a play, broadcast, etc.), to falter with one's words.
触る	さわる	to touch, to feel.
真面目	まじめ	diligent, serious, honest, sober, grave, earnest, steady.
予習	よしゅう	preparation for a lesson.
頂く	いただく	to receive, to get, to accept, to take, to buy., to eat, to drink., to be crowned with, to wear (on one's head), to have (on top)., to have (as one's leader), to live under (a ruler), to install (a president).
喧嘩	けんか	quarrel, brawl, fight, squabble, scuffle.
お礼	おれい, おんれい	thanks, gratitude., manners, etiquette., bow., reward, gift., ceremony, ritual.
折る	おる	to break, to fracture, to break off, to snap off, to pick (e.g. flowers)., to fold, to bend., to make (origami)., to interrupt, to end.
復習	ふくしゅう	review, revision.
片付ける	かたづける	to tidy up, to put in order, to straighten up, to put away., to settle (problem), to clear (dispute)., to finish, to bring something to an end., to marry off (e.g. a daughter)., to do away with someone, to bump someone off.
移る	うつる	to move (house), to transfer (department)., to change the target of interest or concern., to elapse (passage of time)., to be permeated by a colour or scent., to be infected, to be contagious, to spread (as in fire).
済む	すむ	to finish, to end, to be completed., to merely result in something less severe than expected., to feel at ease., to feel unease or guilt for troubling someone, to be sorry.
拾う	ひろう	to pick up, to find, to gather.
眠る	ねむる, ねぶる	to sleep (not necessarily lying down)., to die.
褒める	ほめる	to praise, to admire, to speak well.
足す	たす	to add (numbers)., to add (something), to top up (with something)., to take care of (e.g. one's business).
足りる	たりる	to be sufficient, to be enough., to be worth doing, to be worthy., to be sufficient, to answer, to do.
濡れる	ぬれる	to get wet.
鳴る	なる	to sound, to ring, to resound, to echo, to roar, to rumble.
調べる	しらべる	to examine, to investigate, to check up, to sense, to study, to inquire, to search.
筈	はず	expectation that something took place, will take place or was in some state, it should be so, bound to be, expected to be, must be., nock (of a bow)., nock (of an arrow)., nock-shaped grip (between thumb and forefinger)., wooden frame on the tip of the mast of a Japanese ship that prevents the hawser from falling out.
貰う	もらう	to receive, to take, to accept., to get somebody to do something.
慣れる	なれる	to get used to, to grow accustomed to, to become familiar with., to become skilled in, to become experienced at., to become tame, to become domesticated.
億	おく	10^8, 100,000,000, hundred million.
投げる	なげる	to throw, to cast away., to face defeat, to give up.
戻る	もどる	to turn back, to return, to go back, to recover, to rebound.
寄る	よる	to approach, to draw near, to come near, to be close to., to gather (in one place), to come together, to meet., to stop by (while on one's way to another place), to drop by, to make a short visit., to grow old, to grow high (number, etc.)., to grow (wrinkly)., to lean against, to recline on., to push one's opponent while holding their belt., to decide on a price and come to a deal.
伺う	うかがう	to ask, to inquire, to hear, to be told., to implore (a god for an oracle), to seek direction (from your superior)., to visit., to speak to (a large crowd at a theatre, etc.).
召し上がる	めしあがる	to eat.
植える	うえる	to plant, to grow.
浅い	あさい	shallow, superficial., slight (wound), light (sleep), pale (colour), inadequate (knowledge)., short (time), early, young.
太る	ふとる	to grow fat (stout, plump), to become fat, to gain weight.
祈る	いのる	to pray, to wish.
捨てる	すてる	to throw away, to cast away, to dump, to discard., to abandon, to desert, to leave., to give up, to resign.
手伝う	てつだう	to help, to assist, to aid., to contribute to, to be a factor in.
葡萄	ぶどう, ブドウ, えび	grape, grapevine.
回る	まわる	to turn, to revolve., to visit several places., to function well., to pass a certain time.
遅れる	おくれる	to be late, to be delayed, to fall behind schedule, to be overdue.
亜細亜	アジア, あじあ	Asia (esp. "the Far East")., Asian, Asiatic.
御座います	ございます	to be, to exist.
お帰りなさい	おかえりなさい	welcome home.
お大事に	おだいじに	take care of yourself, get well soon, God bless you, bless you.
お宅	おたく	your house, your home, your family., your husband., your organization., you (referring to someone of equal status with whom one is not especially close).
お土産	おみやげ	present, souvenir.
畏まりました	かしこまりました	certainly!.
屹度	きっと, キッと	surely, undoubtedly, almost certainly, most likely (e.g. 90 percent)., sternly, severely., having no slack, rigid, stiff, tight.
この間	このあいだ, このかん	the other day, lately, recently, during this period., meanwhile, in the meantime.
この頃	このごろ, このころ	recently, nowadays, these days, now, at present.
此れから	これから	after this.
ずっと		continuously in some state (for a long time, distance), throughout, all along, the whole time, all the way., much (better, etc.), by far, far and away., far away, long ago., direct, straight.
其れで	それで	and, thereupon, because of that.
其れに	それに	besides, moreover.
其れ程	それほど	to that degree, extent.
些とも	ちっとも	not at all (neg. verb).
許り	ばかり, ばっかり, ばっか	only, merely, nothing but, no more than., approximately, about., just (finished, etc.)., as if to, (as though) about to., indicates emphasis., always, constantly.
若し	もし	if, in case, supposing.
矢っ張り	やっぱり	too, also, likewise, either., still, as before., even so, either way, nonetheless, in any event, all the same., as expected.
依ると	よると	according to.
アクセサリー		accessory.
アナウンサー		announcer.
アルコール		alcohol.
アルバイト		part-time job, side job., albite.
エスカレーター		escalator.
オートバイ		motorcycle.
オーバー		overcoat., over, exceeding, going beyond, exaggeration., ball hit over the head of an outfielder (baseball).
カーテン		curtain, curtains.
瓦斯	ガス	gas (state of matter, e.g. poison gas, natural gas)., gasoline, gas, petrol., dense fog, thick fog., gas stove, gas cooker, gas range., flatulence, gas, wind, fart.
ガソリン		gasoline, petrol.
ガソリンスタンド		gas station, petrol station.
硝子	ガラス, しょうし	glass, pane., vitreous.
ケーキ		cake.
コンサート		concert.
サラダ		salad.
サンドイッチ		sandwich.
ジャム		jam.
スーツ		suit.
スーパー		super., supermarket., superimpose., superheterodyne., (film with) subtitles.
ステレオ		stereo.
ソフト		soft., software., soft hat, felt hat., soft serve ice cream., softball.
タイプ		type, kind, sort, style., typewriter, typing.
テキスト		text., textbook.
テニス		tennis.
ハンドバッグ		handbag, purse.
パート		part., part-timer., part-time (work).
パソコン		personal computer.
パパ		Papa.
ビル		building., bill.
ピアノ		piano.
プレゼント		present, gift., to give a present or gift.
ベル		bell., bel, B.
ワープロ		word processor.
易い	やすい	easy.
為さる	なさる	to do.
育てる	そだてる	to raise, to rear, to bring up.
員	いん	member.
遠く	とおく	far away, distant, at a distance, distant place, by far.
苛める	いじめる	to tease, to torment, to persecute, to chastise.
会	かい	meeting, assembly, party., association, club.
怪我	けが	injury (to animate object), hurt.
開く	ひらく	to open, to undo, to unseal, to unpack., to bloom, to unfold, to spread out., to open (for business, e.g. in the morning)., to be wide (gap, etc.), to widen., to hold (meeting, etc.), to give, to open., to found (nation, dynasty, sect, etc.), to open (a new business), to set up, to establish, to start., to open (ports, borders, etc.)., to open (an account)., to open up (new land, path, etc.), to clear, to develop., to open (a file, etc.)., to extract (root), to reduce (equation)., to cut open (fish)., to change (kanji into hiragana)., to flare (e.g. skirt)., to slacken (into a poor posture).
割れる	われる	to break, to be smashed., to split, to crack, to fissure, to be torn., to be divided, to cleave., to come to light, to be identified, to be established, to become clear.
乾く	かわく	to get dry.
嬉しい	うれしい	happy, glad, pleasant.
宜しい	よろしい	good, OK, all right, fine, very well, will do, may, can.
吃驚	びっくり, ビックリ	to be surprised, to be amazed, to be frightened, to be astonished, to get startled, to jump., surprise (e.g. surprise party).
泣く	なく	to cry, to weep, to sob, to howl.
驚く	おどろく	to be surprised, to be astonished.
仰っしゃる	おっしゃる	to say, to speak, to tell, to talk.
君	きみ	you, buddy, pal., monarch, ruler, sovereign, (one's) master.
君	くん	Mr (junior), master, boy.
月	つき	moon., month.
建てる	たてる	to build, to construct.
呉れる	くれる	to give, to let one have, to do for one, to be given.
お陰様で	おかげさまで	(I'm fine) thank you, thanks to you, fortunately, under the gods' shadow.
ご主人	ごしゅじん	your husband, her husband.
お釣り	おつり	change (i.e. money), balance.
再来月	さらいげつ	month after next.
再来週	さらいしゅう	week after next.
暫く	しばらく, しゅゆ, すゆ	little while, short while, moment, instant., a while, quite a time., it's been a long time.
仕舞う	しまう	to finish, to stop, to end, to put an end to, to bring to a close., to close (a business, etc.), to close down, to shut down, to shut up., to put away, to put back, to keep, to store., to finish ..., to do ... completely.
市	し	city.
止む	やむ	to cease, to stop, to be over.
止める	とめる	to stop, to turn off., to park., to prevent, to suppress (a cough), to hold back (tears), to hold (one's breath), to relieve (pain)., to stop (someone from doing something), to dissuade, to forbid, to prohibit., to notice, to be aware of, to concentrate on, to pay attention to, to remember, to bear in mind., to fix (in place), to fasten, to tack, to pin, to nail, to button, to staple., to detain, to keep in custody.
止める	やめる	to stop (an activity), to cease, to discontinue, to end, to quit., to cancel, to abandon, to give up, to abolish, to abstain, to refrain.
字	じ	character (i.e. kanji)., hand-writing, penmanship., the ... word (i.e. "the L word" = "love").
式	しき	equation, formula, expression., ceremony., style.
叱る	しかる	to scold.
床屋	とこや	barbershop, barber.
焼く	やく	to bake, to grill., to develop (photos)., to suntan., to burn (in flames, down, CD, DVD, etc.), to scorch., to be jealous, to be envious.
焼ける	やける	to burn, to be roasted, to be heated, to be sunburnt, to fade (in the sun), to glow red (i.e. of the sky at sunset)., to be jealous, to be envious.
寝坊	ねぼう	sleeping in late, oversleeping., late riser, sleepyhead.
心	こころ	mind, heart, spirit., the meaning of a phrase (riddle, etc.).
凄い	すごい	terrible, dreadful., amazing (e.g. of strength), great (e.g. of skills), wonderful, terrific., to a great extent, vast (in numbers).
成るべく	なるべく	as much as possible, wherever practicable.
成程	なるほど, ナルホド	I see, That's right!, Indeed.
製	せい	-made, make.
石	いし	stone., gem, jewel.
折れる	おれる	to break, to be broken, to snap, to fracture., to be folded., to give in, to back down, to yield, to submit., to turn (a corner).
先ず	まず	first (of all), to start with, about, almost, anyway, well, now., hardly (with neg. verb).
続く	つづく	to continue, to last, to go on., to continue (without a break), to be unbroken., to occur again and again., to lead to, to connect to, to adjoin., to come after, to follow, to succeed, to rank next to., to hold out, to keep, to last.
続ける	つづける	to continue, to keep up, to keep on.
大学生	だいがくせい	university student, college student.
知らせる	しらせる	to notify, to advise, to inform.
通り	とおり	avenue, street, way, road., coming and going, street traffic., flow (of water, air, etc.)., transmission (of sound), reach (e.g. of voice)., fame, reputation, popularity., the same status or way, as (e.g. as expected, as I said)., understanding, comprehension., counter for sets of things, counter for methods, ways, types.
天気予報	てんきよほう	weather forecast, weather report.
点く	つく	to be lit (e.g. electricity comes on), to be lighted., to catch fire.
伝える	つたえる	to convey, to report, to transmit, to communicate, to tell, to impart, to propagate, to teach, to bequeath.
動く	うごく	to move, to stir, to shift, to shake, to swing., to operate, to run, to go, to work., to be touched, to be influenced., to change, to vary, to fluctuate, to waver., certain, factual., to be transferred.
届ける	とどける	to deliver, to forward, to send., to report, to notify, to file notice (to the authorities), to give notice, to register.
彼	かれ	he, him., his., boyfriend.
非常に	ひじょうに	very, extremely, exceedingly.
米	こめ, よね, めめ, コメ	(husked grains of) rice., 88 years old.
別	べつ, べち	distinction, difference, different, another, particular, separate, extra, exception.
亡くなる	なくなる	to die.
殆ど	ほとんど	mostly, nearly, practically, well-nigh, almost invariably, all but, just about, almost.
無くなる	なくなる	to be lost (e.g. luggage), to be missing., to be used up, to be run out, to be exhausted, to be consumed, to be reduced to zero, to not occur any more., to disappear (e.g. pain), to be lost (e.g. a dream, confidence).
勿論	もちろん	of course, certainly, naturally.
踊る	おどる	to dance (orig. a hopping dance).
ただ今	ただいま	Here I am, I'm home!., presently, right away, right now, just now.
揺れる	ゆれる	to shake, to sway.
様	さま	Mr., Mrs., Miss, Ms.., makes words more polite (usu. in fixed expressions)., state, situation, appearance.
用	よう	task, business., use, duty, service., call of nature, excretion.
立てる	たてる	to stand up, to put up, to set up, to erect, to raise., to thrust into, to bury into, to dig into., to make (a noise), to start (a rumour), to raise (a cloud of dust, etc.), to cause., to make, to establish, to set up, to develop, to formulate., to put up (a political candidate), to make (one's leader)., to treat with respect, to give (someone) their due, to make (someone) look good, to avoid embarrassing (someone)., to sharpen, to make clear., to shut, to close., to make tea (macha), to perform the tea ceremony., to divide by., to do ... vigorously.
力	ちから	force, strength, might, vigour (vigor), energy., capability, ability, proficiency, capacity, faculty., efficacy, effect., effort, endeavours (endeavors), exertions., power, authority, influence, good offices, agency., support, help, aid, assistance., stress, emphasis., means, resources.
掏摸	すり	pickpocket.
店	てん	-store, -shop.
儘	まま, まんま	as it is, as one likes, because, as., condition, state.
空く	すく	to become less crowded, to thin out, to get empty., to be hungry.
ご馳走	ごちそう	feast, treating (someone)., to treat (someone, e.g. to a meal).
確り	しっかり	tightly (holding on), firmly, securely., strongly (built), solidly, sturdily, steadily., properly, well, sufficiently, hard (working, etc.), fully, completely., reliably, dependably, levelheadedly, shrewdly, wisely, cleverly.
中中	なかなか	very, considerably, easily, readily, fairly, quite, highly, rather., by no means (with negative verb), not readily., middle, half-way point., excellent, wonderful, very good.
髭	ひげ	moustache, beard, whiskers., extremely short pulse appearing on an electrical signal.
酷い	ひどい	cruel, heartless, hard, harsh, severe., violent, intense, strong, heavy, extreme., very bad, terrible, awful., excessive, exorbitant, unreasonable, outrageous, unfair, unjust.
痩せる	やせる	to become thin, to lose weight, to reduce (one's) weight, to slim., to be barren, to be infertile, to be sterile.
様	よう	appearing ..., looking ...., way to ..., method of ...ing., form, style, design., like, similar to., thing (thought or spoken).
沸く	わく	to grow hot (of water, etc.), to boil., to be in a state of excitement, to get excited, to take place energetically, to erupt (e.g. in applause, cheers).
お祝い	おいわい	congratulation, congratulations, celebration, festival, congratulatory gift.
偶に	たまに	occasionally, once in a while.
行ってらっしゃい	いってらっしゃい	have a good day, take care, see you.
然う	そう	in that way (concerning the actions of the listener or concerning the ideas expressed or understood by the listener; with a neg. sentence, implies that something isn't as much as one might think), thus, such., so (used to express agreement with something said)., so? (used to express some doubt with something said).
ご覧になる	ごらんになる	to see, to look, to watch., (after the -te form of a verb) try to.
あんな		such (about something or someone distant from both speaker and listener, or about a situation unfamiliar to both speaker and listener), so, that, sort of.
いらっしゃる		to come, to go, to be (somewhere)., (after a -te form, or the particle "de") is (doing), are (doing).
うん		yes, yeah, uh huh.
お目出度うご座います	おめでとうございます	congratulations.
斯う	こう	in this way (used for something or someone close to the speaker, including the speaker himself, or for the opinions of the speaker), thus, such., uh... (interjection used as a verbal pause).
さっき		some time ago, just now.
すっかり		all, completely, thoroughly.
すっと		straight, quickly, directly, all of a sudden., quietly, gently, softly., to feel refreshed, to feel satisfied.
すると		thereupon, hereupon.
そんな		such (about the actions of the listener, or about ideas expressed or understood by the listener), like that, that sort of.
だから		so, therefore.
ちゃん		suffix for familiar person.
どんどん		drumming (noise)., rapidly, steadily.
はっきり		clearly, plainly, distinctly., to be clear, to be definite, to be certain, to be exact, to become clear, to clear up.
やっと		at last, at length., barely, narrowly, just, by the skin of one's teeth.
キット		kit.
クラブ		club (e.g. golf, tennis)., clubs (card suit)., crab.
サンダル		sandal.
スーツケース		suitcase.
スクリーン		screen.
ステーキ		steak.
チェック		check, plaid.
ハンバーグ		hamburger (meat, no bun), Hamburg steak.
ファックス		facsimile, FAX.
レジ		(cash) register.
亜米利加	アメリカ	America., United States of America.
そろそろ		slowly, quietly, steadily, gradually, gingerly., soon, momentarily, before long, any time now.
行けません	いけません	wrong, not good, of no use., hopeless, past hope., must not do.
阿弗利加	アフリカ	Africa.
そんなに		so much, so, like that.
や		such things as (non-exhaustive list related to a specific time and place), and ... and., (after the dictionary form of a verb) the minute (that) ..., no sooner than ...., punctuational exclamation in haiku, renga, etc.., interjection expressing surprise., hi., plain copula.
ああ		like that (used for something or someone distant from both speaker and listener), so.
し		(at the end of a phrase) notes one (of several) reasons.
降り出す	ふりだす	to begin to rain, to begin to snow.
難い	かたい	difficult, hard.
お出でになる	おいでになる	to be., to come., to go.
お蔭	おかげ	grace (of God), benevolence (of Buddha), blessing., assistance, help, aid., effects, influence.
お見舞い	おみまい	calling on someone who is ill, enquiry, inquiry.
お子さん	おこさん	child.
稲子	いなご, こう	rice grasshopper (of genus Oxya)., grasshopper, locust (of family Catantopidae).
劫	こう, ごう	kalpa (eon, aeon)., ko (in Go, the arrangement that allows for the eternal capture and recapture of the same stones).
お祭り	おまつり	festival, feast, carnival.
都	と	metropolitan, municipal.
御名	みな	name of God (esp. in Christian contexts), name of Christ.
幾らでも	いくらでも	as many (much) as one likes.
看護師	かんごし	(hospital) nurse, registered nurse, RN.
代	だい	charge, cost, price., generation, age, reign., era., (after someone's name or title) a representative of, on behalf of, for (someone)., used after a phone number to indicate that it is a switchboard number., counter for decades of ages, eras, etc.., counter for generations (of inheritors to a throne, etc.)., proxy application company., pronoun.
泳ぎ方	およぎかた	way of swimming.
もう直ぐ	もうすぐ	very soon.
杯	はい, はた	sake cup, cup for alcoholic beverages., counter for cupfuls., counter for ships, octopuses and squid.
素っ	すっ	most (emphasis), much, greatly.
軒	けん	counter for buildings (esp. houses)., suffix for a pen name, stage name, etc..
鸛	こうのとり, こう, コウノトリ	stork (esp. the Oriental stork, Ciconia boyciana).
中	じゅう, ぢゅう	through, throughout, in the course of., all over or throughout (e.g. a place).
行ってまいります	いってまいります	good bye, I'm off, see you later.
お待たせしました	おまたせしました	Thank you for waiting, Have I kept you waiting?.
家	か	-ist (used after a noun indicating someone's occupation, pursuits, disposition, etc.), -er.
あ		Ah! (expression of surprise, recollection, etc.), Oh!., Hey! (to get someone's attention).
びる		seeming to be ..., becoming like ..., behaving as ....
ケレド		credo.
