夕べ	ゆうべ, ゆう, さくや	evening., last night.
上げる	あげる	to raise, to elevate., to do up (one's hair)., to fly (a kite, etc.), to launch (fireworks, etc.), to surface (a submarine, etc.)., to land (a boat)., to deep-fry., to show someone (into a room)., (uk) to summon (for geishas, etc.)., to send someone (away)., to enrol (one's child in school), to enroll., to increase (price, quality, status, etc.), to develop (talent, skill), to improve., to make (a loud sound), to raise (one's voice)., to earn (something desirable)., to praise., to give (an example, etc.), to cite., to summon up (all of one's energy, etc.)., to arrest., to nominate., to give., to offer up (incense, a prayer, etc.) to the gods (or Buddha, etc.)., to bear (a child)., to conduct (a ceremony, esp. a wedding)., (of the tide) to come in., to vomit., to do for (the sake of someone else)., to complete ...., to humbly do ....
一人	ひとり, いちにん	one person., alone, unmarried, solitary.
在る	ある	to be (usu. of inanimate objects), to exist, to live., to have., to be located., to be equipped with., to happen, to come about.
作る	つくる	to make, to produce, to manufacture, to build, to construct., to prepare (food), to brew (alcohol)., to raise, to grow, to cultivate, to train., to till., to draw up (a document), to make out, to prepare, to write., to create (an artistic work, etc.), to compose., to coin (a phrase), to organize, to organise, to establish, to found., to have (a child)., to make up (one's face, etc.)., to fabricate (an excuse, etc.)., to form (a line, etc.)., to set (a record)., to commit (a sin, etc.).
足	あし	foot., leg., gait., pace., bottom structural component (i.e. radical) of a kanji., means of transportation.
川	かわ, がわ	river, stream., the .... river, (suffix used with the names of rivers).
歌	うた	song., classical Japanese poetry (esp. tanka)., modern poetry.
子供	こども	child, children.
体	からだ, しんたい, しんだい, しんてい	body., torso, trunk., build, physique, constitution., health., corpse, dead body.
明日	あした, あす, みょうにち	tomorrow., near future.
歌う	うたう	to sing., to sing (one's praises in a poem, etc.), to compose a poem, to recite a poem.
女の子	おんなのこ, おんなのコ, おんにゃのこ	girl.
男の子	おとこのこ, おとこのコ	boy, male child, baby boy.
否	いいえ, いいや, いえ, いな, いや	no, nay., well, er, why.
早い	はやい	fast, quick, hasty, brisk., early (in the day, etc.), premature., (too) soon, not yet, (too) early., easy, simple, quick.
返す	かえす	to return (something), to restore, to put back., to turn over, to turn upside down, to overturn., to pay back, to retaliate, to reciprocate., (after the -masu stem of a verb) to repeat ..., to do ... back.
歳	さい	-years-old., ability, gift, talent, aptitude, genius.
止まる	とまる	to stop (moving), to come to a stop., to stop (doing, working, being supplied), to come to a halt, to cease, to be stopped, to be suspended., to alight, to perch on.
赤い	あかい	red., Red (i.e. communist).
上る	のぼる	to ascend, to go up, to climb., to ascend (as a natural process, e.g. the sun), to rise., to go to (the capital)., to be promoted., to add up to., to advance (in price)., to swim up (a river), to sail up., to come up (on the agenda).
私	わたし, わたくし	I, me., private affairs, personal matter, secrecy., selfishness.
九	きゅう, く, ここの, この, ここ	nine.
三	さん, み	three., tri-.
四	し, よん, よ	four.
十	じゅう, と, とお	10, ten.
言う	いう, ゆう	to say, to utter, to declare., to name, to call., to go (e.g. "the alarm went ping"), to make a noise.
一昨年	いっさくねん, おととし	year before last.
何	なに, なん	what., how many (some counter)., euph. for genitals or sex.
今日	きょう, こんにち, こんち, こんじつ	today, this day., these days, recently, nowadays.
毎年	まいとし, まいねん	every year, yearly, annually.
皆	みな, みんな	all, everyone, everybody., everything.
入口	いりぐち, いりくち, はいりぐち, はいりくち	entrance, entry, gate, approach, mouth.
勤める	つとめる	to work (for), to be employed (at), to serve (in)., to serve (as), to act (as), to fill (the position of), to play the role (of)., to conduct a religious service.
買い物	かいもの	shopping, purchased goods.
良い	よい, いい	good, excellent, fine, nice, pleasant, agreeable., sufficient (can be used to turn down an offer), ready, prepared., profitable (e.g. deal, business offer, etc.), beneficial., OK.
昨日	きのう, さくじつ	yesterday.
降りる	おりる	to descend (e.g. a mountain), to go down, to come down., to alight (e.g. from bus), to get off, to disembark, to dismount., to step down, to retire, to give up, to quit., to be granted, to be issued, to be given., to form (of frost, dew, mist, etc.)., to be passed (from the body; e.g. of a roundworm).
余り	あまり, あんまり	remainder, rest, balance, remains, scraps, residue, remnant., not very (with negative sentence), not much., surplus, excess, fullness, too much., overjoyed, overwhelmed., more than, over.
目	め	eye, eyeball., eyesight, sight, vision., look, stare, glance., an experience., viewpoint., stitch, texture, weave., ordinal number suffix., somewhat, -ish.
始め	はじめ	beginning, start, outset, opening., first (in line, etc.)., origin., such as ..., not to mention ....
魚	さかな, うお	fish.
丸い	まるい, まろい	round, circular, spherical., harmonious, calm.
飲み物	のみもの	drink, beverage.
意味	いみ	meaning, significance.
一つ	ひとつ	one., for one thing., only., (not) even., just (e.g. "just try it").
一番	いちばん	best, first, number one., game, round, bout, fall, event (in a meet).
右	みぎ	right, right hand side., afore-mentioned (esp. in vertical Japanese writing), foregoing, forgoing, above.
映画	えいが	movie, film.
音楽	おんがく	music, musical movement.
夏	なつ	summer.
家族	かぞく	family, members of a family.
家庭	かてい	home, family, household.
花	はな	flower, blossom, bloom, petal., blooming (esp. of cherry blossoms), cherry blossom., ikebana., Japanese playing cards., beauty., (the) best.
会社	かいしゃ	company, corporation., workplace.
外国	がいこく, そとぐに	foreign country.
外国人	がいこくじん	foreigner, foreign citizen, foreign national, alien, non-Japanese.
学校	がっこう	school.
学生	がくせい	student (esp. a university student).
顔	かお, がん	face, visage., look, expression, countenance., honor, honour, face., influence, notoriety.
銀行	ぎんこう	bank.
言葉	ことば, けとば	language, dialect., word, words, phrase, term, expression, remark., speech, (manner of) speaking.
五	ご, いつ, い	five.
午後	ごご	afternoon, p.m..
午前	ごぜん	morning, a.m..
後	あと	behind, rear., after, later., after one's death., remainder, the rest., descendant, successor, heir., more (e.g. five more minutes), left.
今月	こんげつ	this month.
左	ひだり	left, left hand side.
仕事	しごと	work, job, business, occupation, employment, vocation, task., work.
時間	じかん	time., hours.
自動車	じどうしゃ	automobile.
自分	じぶん	myself, yourself, oneself, himself, herself., I, me.
七	しち, なな, な	seven., hepta-.
質問	しつもん	question, inquiry, enquiry.
写真	しゃしん	photograph, photo, picture, snapshot, snap., movie.
車	くるま	car, automobile, vehicle., wheel.
手	て	hand, arm., forepaw, foreleg., handle., hand, worker, help., trouble, care, effort., means, way, trick, move, technique, workmanship., hand, handwriting., kind, type, sort., one's hands, one's possession., ability to cope., hand (of cards)., direction., move (in go, shogi, etc.).
秋	あき	autumn, fall.
春	はる	spring, springtime., New Year., prime (of one's life, etc.)., adolescence, puberty., sexuality.
少し	すこし	small quantity, little, few, something., little while., short distance.
新聞	しんぶん	newspaper.
水	みず, み	water (esp. cool, fresh water, e.g. drinking water)., fluid (esp. in an animal tissue), liquid., flood, floodwaters., water offered to wrestlers just prior to a bout., break granted to wrestlers engaged in a prolonged bout.
声	こえ	voice.
千	せん, ち	1,000, thousand.
台	だい	stand, rack, table., support., belt., counter for machines, incl. vehicles., setting (e.g. in jewellery)., level (e.g. price level), range (e.g. after physical units), period (of time, e.g. a decade of one's life).
大学	だいがく	post-secondary education institution, incl. university, college, etc.., former central university of Kyoto (established under the ritsuryo system for the training of government administrators)., the Great Learning - one of the Four Books.
男	おとこ, おっこ	man, male., fellow, guy, chap, bloke., male lover, boyfriend, man., manliness, manly honor, manly honour, manly reputation.
電話	でんわ	telephone call, phone call., telephone (device), phone.
東	ひがし, ひむかし, ひんがし	east.
道	みち	road, street, way, path, course, route, lane., distance, ways (e.g. "a long ways")., the way (of proper conduct, etc.), one's way, morals., teachings (esp. Confucian or Buddhist), dogma., field (of medicine, etc.), subject., way, method, means.
南	みなみ	south.
二	に, ふた, ふ, ふう	two.
百	ひゃく, もも	100, hundred.
病院	びょういん	hospital.
父	ちち, とと, ちゃん, てて, かぞ, かそ, しし, あて	father.
母	はは, はわ, かか, おも, いろは, あも	mother.
北	きた	north.
毎日	まいにち	every day.
木	き	tree, wood, timber.
問題	もんだい	question (e.g. on a test), problem., problem (e.g. societal, political), question, issue, subject (e.g. of research), case, matter., question (i.e. doubt)., public discussion, controversy., trouble, problem, inconvenience, difficulty.
来年	らいねん	next year.
今年	ことし, こんねん	this year.
二人	ふたり, ににん	two persons, two people, pair, couple.
八	はち, や	eight.
六	ろく, む, むう	six.
国	くに	country, (the) state., region., home (i.e. hometown, home country).
話	はなし	talk, speech, chat, story, conversation., discussions, negotiation, argument.
一緒	いっしょ	together., at the same time., same, identical.
雨	あめ	rain.
英語	えいご	English (language).
火	ひ	fire, flame, blaze.
海	うみ, み, わた, わだ	sea, beach.
外	そと, と	outside, exterior., open air., other place.
結婚	けっこん	marriage.
呼ぶ	よぶ	to call out (to), to call, to invoke., to summon (a doctor, etc.)., to invite., to designate, to name, to brand., to garner (support, etc.), to gather.
公園	こうえん	(public) park.
口	くち	mouth., opening, hole, gap, orifice., mouth (of a bottle), spout, nozzle, mouthpiece., gate, door, entrance, exit., speaking, speech, talk (i.e. gossip)., taste, palate., mouth (to feed)., opening (i.e. vacancy), available position., invitation, summons., kind, sort, type., opening (i.e. beginning)., counter for mouthfuls, shares (of money), and swords.
雑誌	ざっし	journal, magazine, periodical.
山	やま	mountain, hill., mine (e.g. coal mine)., heap, pile., crown (of a hat), thread (of a screw), tread (of a tire)., climax, peak, critical point., guess, speculation., criminal case, crime., festival float (esp. one mounted with a decorative halberd)., wall (mahjong), wall tile., wild.
使う	つかう	to use (a thing, method, etc.), to make use of, to put to use., to use (a person, animal, puppet, etc.), to employ, to handle, to manage, to manipulate., to use (time, money, etc.), to spend, to consume., to use (language), to speak.
女	おんな, おみな, おうな, うみな, おな	woman, female., female lover, girlfriend, mistress, woman.
色	いろ	colour, color., complexion., appearance, look., love, lust, sensuality, love affair, lover., kind, type, variety.
生徒	せいと	pupil.
西	にし	west.
先月	せんげつ	last month.
先生	せんせい, せんじょう	teacher, master, doctor., with names of teachers, etc. as an honorific.
大切	たいせつ, たいせち	important, necessary, indispensable., beloved, precious, dear, cherished, valuable., careful.
大変	たいへん	very, greatly., immense, enormous, great., serious, grave, dreadful, terrible., difficult, hard.
知る	しる	to be aware of, to know, to be conscious of, to cognize, to cognise., to notice, to feel., to understand, to comprehend, to grasp., to remember, to be acquainted with (a procedure)., to experience, to go through, to learn., to be acquainted with (a person), to get to know., to concern.
電気	でんき	electricity., (electric) light.
動物	どうぶつ	animal.
二つ	ふたつ	two.
年	とし	year., many years., age., past one's prime, old age.
半分	はんぶん	half.
病気	びょうき	illness, disease, sickness.
部屋	へや	room., stable.
本当	ほんとう, ほんと	truth, reality, actuality, fact., proper, right, correct, official., genuine, authentic, natural, veritable.
名前	なまえ	name, full name., given name, first name.
夜	よる, よ	evening, night.
旅行	りょこう	travel, trip.
料理	りょうり	cooking, cookery, cuisine., dealing with something, handling, administration, management.
練習	れんしゅう	practice, practising.
町	まち, ちょう	town, block, neighbourhood, neighborhood., street, road., 109.09 m., 0.99 hectares.
会う	あう	to meet, to encounter, to see., to have an accident, to have a bad experience.
横	よこ	horizontal (as opposed to vertical), lying down., side-to-side (as opposed to front-to-back), width, breadth., side (of a box, etc.)., beside, aside, next to., unconnected.
教室	きょうしつ	classroom., department, laboratory., single-room school, small school.
建物	たてもの	building.
犬	いぬ	dog (Canis (lupus) familiaris)., snoop (i.e. a detective, a spy, etc.)., loser, asshole., counterfeit, inferior, useless, wasteful.
黒	くろ	black., black go stone., guilt, guilty person.
三つ	みっつ, みつ	three.
紙	かみ	paper.
耳	みみ	ear., hearing., edge, crust., selvedge (non-fray machined edge of fabrics), selvage.
手紙	てがみ	letter.
授業	じゅぎょう	lesson, class work, teaching, instruction.
出す	だす	to take out, to get out., to put out, to reveal, to show., to submit (e.g. thesis), to turn in., to publish, to make public., to send (e.g. letter)., to produce (a sound), to start (fire)., to serve (food)., to begin ..., to start to ..., to burst into ....
青	あお	blue., green., green light., black (horse coat color)., immature, unripe, young.
雪	ゆき	snow.
全部	ぜんぶ	all, entire, whole, altogether.
側	そば, そく, はた	near, close, beside, vicinity, proximity, besides, while., third person.
村	むら	village.
大使館	たいしかん	embassy.
大人	おとな, だいにん	adult.
冬	ふゆ	winter.
日	ひ	day, days., sun, sunshine, sunlight., case (esp. unfortunate), event.
白	しろ	white., innocence, innocent person., blank space., white go stone., white dragon tile (mahjong)., skewered grilled pig intestine.
半	はん	half, semi-., half-past., odd number.
番号	ばんごう	number, series of digits.
勉強	べんきょう	study., diligence., discount, reduction.
野菜	やさい	vegetable.
有名	ゆうめい	famous., fame.
来月	らいげつ	next month.
緑	みどり	green., greenery (esp. fresh verdure).
門	かど, もん	gate., branch of learning based on the teachings of a single master., division., counter for cannons.
両親	りょうしん, ふたおや	parents, both parents.
お金	おかね	money.
広い	ひろい	spacious, vast, wide.
時	とき	time, hour, moment., occasion, case., chance, opportunity, season., the times, the age, the day., tense.
自転車	じてんしゃ, じでんしゃ	bicycle.
窓	まど	window.
大勢	おおぜい, たいぜい	many, crowd, great number of people.
昼	ひる	noon, midday., daytime., lunch.
鳥	とり	bird., bird meat (esp. chicken meat), fowl, poultry.
電車	でんしゃ	train, electric train.
服	ふく	clothes (esp. Western clothes)., counter for doses of medicine, gulps of tea, drags of a cigarette, etc..
薬	くすり	medicine, pharmaceuticals, (legal) drugs., efficacious chemical (i.e. gunpowder, pesticide, etc.)., (pottery) glaze., small bribe.
隣	となり	neighbor (neighbour), next to (esp. living next door to).
弟	おとうと, おと, おとと, てい	younger brother.
匹	ひき, き	counter for small animals., counter for rolls of cloth (two han in size)., roll of cloth.
分かる	わかる	to understand, to comprehend, to grasp, to see, to get, to follow., to become clear, to be known, to be discovered, to be realized, to be realised, to be found out.
お母さん	おかあさん	mother.
駅	えき	station.
円	えん	yen, Japanese monetary unit., circle.
夏休み	なつやすみ	summer vacation, summer holiday.
休み	やすみ	rest, recess, respite., vacation, holiday, absence, suspension., dormancy (of a silkworm prior to moulting).
橋	はし	bridge.
兄	あに	elder brother, older brother.
兄弟	きょうだい, けいてい	siblings, brothers and sisters., brothers., siblings-in-law, brothers-in-law, sisters-in-law., mate, friend.
警官	けいかん	policeman.
玄関	げんかん	entranceway, entry hall, vestibule, foyer, entryway, mud room.
今週	こんしゅう	this week.
歯	は	tooth.
図書館	としょかん, ずしょかん	library.
静か	しずか	quiet, silent., slow, unhurried., calm, peaceful.
先週	せんしゅう	last week, the week before.
地下鉄	ちかてつ	underground train, subway.
地図	ちず	map.
池	いけ	pond.
肉	にく, しし	flesh., meat., the physical body (as opposed to the spirit)., thickness., ink pad.
飛行機	ひこうき	aeroplane, airplane, aircraft.
文章	ぶんしょう	sentence, article, composition., (writing) style.
毎週	まいしゅう	every week.
友達	ともだち	friend, companion.
卵	たまご	eggs, egg, spawn, roe., hen egg., (an expert) in the making., beginning, origin, infancy.
留学生	りゅうがくせい	overseas student, exchange student.
毎月	まいつき, まいげつ	every month, each month, monthly.
お茶	おちゃ	tea (usu. green)., tea break (at work)., tea ceremony.
医者	いしゃ	(medical) doctor, physician.
過ぎ	すぎ	past, after., too (much), over (e.g. eating).
皆さん	みなさん, みんなさん	all, everyone, everybody.
角	かど	corner (e.g. desk, pavement)., edge.
靴	くつ	shoes, boots, footwear, footgear.
元気	げんき	health(y), robust, vigor, vigour, energy, vitality, vim, stamina, spirit, courage, pep.
後ろ	うしろ	back, behind, rear.
四つ	よっつ, よつ	four.
取る	とる	to take, to pick up, to harvest, to earn, to win, to choose., to steal., to eat, to have (a meal)., to remove (one's glasses, etc.)., to compete (in sumo, cards, etc.), to play.
大丈夫	だいじょうぶ	safe, all right, OK, okay.
庭	にわ	garden, yard, courtyard., field (of action), area.
天気	てんき	weather, the elements., fair weather, fine weather.
便利	べんり	convenient, handy, useful.
妹	いもうと	younger sister.
来週	らいしゅう	next week.
立派	りっぱ	splendid, fine, handsome, elegant, imposing, prominent, legal, legitimate.
塩	しお, えん	salt (i.e. sodium chloride), common salt, table salt., salt (e.g. sodium chloride, calcium sulfate, etc.)., hardship, toil, trouble., saltiness.
お父さん	おとうさん, おとっさん	father, dad, papa, pa, pop, daddy, dada.
階段	かいだん	stairs, stairway, staircase.
漢字	かんじ	Chinese characters, kanji.
机	つくえ, つき	desk.
戸	と	door (esp. Japanese-style).
今	いま	now, the present time, just now, soon, immediately, (one) more.
姉	あね	older sister, elder sister.
時計	とけい, ときはかり	watch, clock, timepiece.
台所	だいどころ, だいどこ	kitchen.
難しい	むずかしい, むつかしい	difficult, hard, troublesome, complicated, serious (disease, problem, etc.)., fussy, particular, fastidious, hard to please, displeased., gloomy, glum, sullen, serious (look).
猫	ねこ, ネコ	cat., shamisen., geisha., wheelbarrow., clay bed-warmer., bottom, submissive partner of a homosexual relationship.
晩	ばん	evening., counter for nights.
郵便局	ゆうびんきょく	post office.
夕方	ゆうがた	evening, dusk.
嫌	いや, や	disagreeable, detestable, unpleasant, reluctant.
大きい	おおきい	big, large, great, loud.
時々	ときどき	sometimes, at times.
押す	おす	to push, to press., to apply pressure from above, to press down., to stamp (i.e. a passport), to apply a seal., to affix (e.g. gold leaf)., to press (someone for something), to urge, to compel, to influence., to overwhelm, to overpower, to repress., to push (events along), to advance (a plan)., to do in spite of ..., to do even though ..., to force., to make sure., to be pressed for time., to advance troops, to attack., (of light) to be diffused across an entire surface.
階	かい	storey, story, floor., stairs., stage (in chronostratigraphy)., counter for storeys and floors of a building.
牛肉	ぎゅうにく	beef.
牛乳	ぎゅうにゅう	(cow's) milk.
結構	けっこう	splendid, nice, wonderful, delicious, sweet., sufficient, fine (in the sense of "I'm fine"), (by implication) no thank you., well enough, OK, tolerable., reasonably, fairly, tolerably.
嫌い	きらい	dislike, hate., suspicion, tendency, smack (of)., distinction, discrimination.
高い	たかい	high, tall., expensive.
砂糖	さとう	sugar.
持つ	もつ	to hold (in one's hand), to take, to carry., to possess, to have, to own., to maintain, to keep., to last, to be durable, to keep, to survive., to take charge of, to be in charge of.
縦	たて	the vertical, height., front-to-back, length., north-to-south., vertical (relationship), hierarchy., (weaving) warp.
出口	でぐち	exit, gateway, way out, outlet, leak, vent.
食べ物	たべもの	food.
食堂	しょくどう	dining room, dining hall, cafeteria, messroom., restaurant, eatery, snack bar, diner.
新しい	あたらしい	new, novel, fresh, recent, latest, up-to-date, modern.
切手	きって	stamp (postage), merchandise certificate.
大好き	だいすき	loveable, very likeable, like very much.
売る	うる	to sell.
鼻	はな	nose.
頼む	たのむ	to request, to beg, to ask., to call, to order, to reserve., to entrust to., to rely on.
冷蔵庫	れいぞうこ	refrigerator.
映画館	えいがかん	movie theatre (theater), cinema.
果物	くだもの, かぶつ	fruit.
荷物	にもつ	luggage, baggage, package., burden., payload (of a packet, cell, etc.).
回	かい	counter for occurrences., counter for games, rounds, etc., counter for innings (baseball)., Islam., Hui (people).
五つ	いつつ	five.
作文	さくぶん	writing (an essay, prose, etc.), composition., formal writing with little real meaning.
洗濯	せんたく	washing, laundry.
掃除	そうじ	cleaning, sweeping.
朝	あさ, あした	morning.
背	せい	height, stature.
帽子	ぼうし	hat, cap.
明るい	あかるい	bright, colourful., cheerful., familiar (with), knowledgeable (about)., fair (e.g. politics), clean.
浴びる	あびる	to dash over oneself (e.g. water), to bathe, to bask in (e.g. the sun), to be flooded with (e.g. light), to shower., to suffer (e.g. an attack), to have abuse heaped upon, to draw criticism upon oneself.
風邪	かぜ, ふうじゃ	common cold, cold, influenza, flu, ague.
箱	はこ, ハコ	box, case, chest, package, pack., car (of a train, etc.)., shamisen case, shamisen., public building, community building., counter for boxes (or boxed objects).
喫茶店	きっさてん, きっちゃてん	teahouse, tearoom, coffee lounge, coffee shop, (rather formal) cafe.
去年	きょねん, こぞ	last year.
財布	さいふ	purse, handbag, wallet.
散歩	さんぽ	walk, stroll.
辞書	じしょ	dictionary, lexicon.
切符	きっぷ	ticket.
走る	はしる	to run., to travel (movement of vehicles), to drive., to hurry to., to retreat (from battle), to take flight., to run away from home., to elope., to tend heavily toward.
買う	かう	to buy, to purchase., to value, to have a high opinion., to stir, to provoke.
辺	へん	area, vicinity., side (of triangle, rectangle, etc.)., circumstances.
廊下	ろうか	corridor, hallway, passageway.
傘	かさ	umbrella, parasol.
切る	きる	to cut, to cut through, to perform (surgery)., to sever (connections, ties)., to turn off (i.e. the light)., to terminate (i.e. a conversation), to hang up (the phone), to disconnect., to punch (a ticket), to tear off (a stub)., to open (something sealed)., to start., to set (a limit), to do (something) in less or within a certain time, to issue (stamps, vouchers, etc.)., to reduce, to decrease, to discount., to shake off (water, etc.), to let drip-dry, to let drain., to cross, to traverse., to criticize sharply., to act decisively, to do (something noticeable), to go first, to make (certain facial expressions, in kabuki)., to turn (a vehicle)., to curl (a ball), to bend, to cut., to shuffle (cards)., to dismiss, to sack, to let go, to expulse, to excommunicate., to dig (a groove), to cut (a stencil, on a mimeograph)., to trump., (in Go) to isolate (an opponent's stone)., to start a fire (with wood-wood friction or by striking a metal against stone)., to draw (a shape) in the air (with a sword, etc.)., to finish, to complete.
渡す	わたす	to ferry across (a river, etc.), to carry across, to traverse., to lay across, to build across., to hand over, to hand in, to pass, to give, to transfer.
封筒	ふうとう	envelope.
毎朝	まいあさ, まいちょう	every morning.
洋服	ようふく	Western-style clothes (cf traditional Japanese clothes).
黄色	きいろ, こうしょく, おうしょく	yellow, amber.
終わる	おわる	to finish, to end, to close.
交差点	こうさてん	crossing, intersection.
鉛筆	えんぴつ	pencil.
週間	しゅうかん	week, weekly.
出る	でる	to leave, to exit, to go out, to come out, to get out., to leave (on a journey), to depart, to start out, to set out., to move forward., to come to, to get to, to lead to, to reach., to appear, to come out, to emerge, to surface, to come forth, to turn up, to be found, to be detected, to be discovered, to be exposed, to show, to be exhibited, to be on display., to appear (in print), to be published, to be announced, to be issued, to be listed, to come out., to attend, to participate, to take part, to enter (an event), to play in, to perform., to be stated, to be expressed, to come up, to be brought up, to be raised., to sell., to exceed, to go over., to stick out, to protrude., to break out, to occur, to start, to originate., to be produced., to come from, to be derived from., to be given, to get, to receive, to be offered, to be provided, to be presented, to be submitted, to be handed in, to be turned in, to be paid., to answer (phone, door, etc.), to get., to assume (an attitude), to act, to behave., to pick up (speed, etc.), to gain., to flow (e.g. tears), to run, to bleed., to graduate.
上手	じょうず, じょうて, じょうしゅ	skill, skillful, dexterity., flattery.
読む	よむ	to read., to count.
背広	せびろ, セビロ	business suit.
方	ほう	direction, way, side, area (in a particular direction)., side (of an argument, etc.), one's part., type, category., field (of study, etc.)., indicates one side of a comparison., way, method, manner, means., length (of each side of a square).
紅茶	こうちゃ	black tea.
七つ	ななつ	seven.
借りる	かりる	to borrow, to have a loan., to rent, to hire.
宿題	しゅくだい	homework.
多分	たぶん	perhaps, probably., generous, many, much, great.
誰	だれ, たれ, た	who.
着る	きる	to wear (in modern Japanese, from the shoulders down), to put on., to bear (guilt, etc.).
眼鏡	めがね, がんきょう, メガネ	spectacles, glasses., judgement, discrimination, discernment, insight.
見る	みる	to see, to look, to watch, to view, to observe., to look over, to look on, to assess, to examine, to judge., to look after, to keep an eye on, to take care of., to view (e.g. flowers, movie)., to try, to try out., to see that..., to find that....
低い	ひくい	low (rank, degree, value, content, quality, etc.)., low (position), close to the ground., short (height)., deep (voice), in a low key, low (volume).
熱い	あつい	hot (thing)., passionate (feelings, etc.), ardent, hot (e.g. gaze)., hot (e.g. temper)., zealous, enthusiastic, fired up., intense, severe, extreme., hot (topic), of interest.
暇	ひま, いとま, ヒマ	spare time, free time, leisure., time off, day off, vacation, holiday, leave., quitting (one's job), firing someone, divorcing (one's spouse)., (of one's time) free, (of one's business) slow., leaving, departing.
下手	へた	unskillful, poor, awkward., imprudent, untactful.
向こう	むこう	opposite side, other side, opposite direction., over there, that way, far away, beyond., the other party, the other person., future (starting now).
出来る	できる	to be able (in a position) to do, to be up to the task., to be ready, to be completed., to be made, to be built., to be good at, to be permitted (to do)., to become intimate, to take up (with somebody)., to grow, to be raised., to become pregnant.
寝る	ねる	to lie down., to go to bed, to lie in bed., to sleep (lying down)., to sleep (with someone, i.e. have intercourse)., to lie idle.
晴れ	はれ	clear weather, fine weather., formal, ceremonial, public., cleared of suspicion.
茶色	ちゃいろ	light brown, tawny.
長い	ながい	long (distance)., long (time), lengthy.
丈夫	じょうぶ	healthy, robust, strong, solid, durable.
カ月	かげつ	(number of) months.
楽しい	たのしい	enjoyable, fun.
幾つ	いくつ	how many?., how old?.
古い	ふるい	old (not person), aged, ancient, antiquated, stale, threadbare, outmoded, obsolete article.
細い	ほそい	thin, slender, fine., unlucky (billiards slang).
少ない	すくない	few, a little, scarce, insufficient, seldom.
痛い	いたい	painful, sore., exceeding.
白い	しろい	white.
来る	くる	to come (spatially or temporally), to approach, to arrive., to come back, to do ... and come back., to come to be, to become, to get, to grow, to continue., to come from, to be caused by, to derive from., to come to (i.e. "when it comes to spinach ...").
火曜日	かようび	Tuesday.
豚肉	ぶたにく, とんにく	pork.
上着	うわぎ, じょうい	coat, tunic, jacket, outer garment.
強い	つよい	strong, powerful, mighty, potent., resistant, resilient, durable.
鍵	かぎ	key., lock.
交番	こうばん	police box., alternation, alternating (e.g. current).
黒い	くろい	black., dark., illicit, wicked, underground.
待つ	まつ	to wait., to await, to look forward to, to anticipate., to depend on, to need.
遅い	おそい	slow., late (e.g. "late at night")., too late.
忙しい	いそがしい, せわしい	busy, hectic, occupied, engaged.
毎晩	まいばん	every night.
欲しい	ほしい	wanted, wished for, in need of, desired., I want (you) to.
甘い	あまい	sweet-tasting, sweet, sugary, sugared., fragrant (smelling), sweet (music)., lightly salted, light in salt, not spicy., naive, overly optimistic, soft on, generous, indulgent, easy-going, lenient., half-hearted, not finished properly., insufficient, not satisfactory, inadequate, loose., mild., tempting, enticing, luring.
靴下	くつした	socks, sock, stockings, stocking.
語	ご	language., word.
箸	はし	chopsticks.
又	また	again, and, also, still (doing something).
面白い	おもしろい	interesting, amusing.
今朝	けさ, こんちょう	this morning.
泳ぐ	およぐ	to swim.
掛ける	かける	to hang (e.g. picture), to hoist (e.g. sail), to raise (e.g. flag)., to sit., to take (time, money), to expend (money, time, etc.)., to make (a call)., to multiply., to secure (e.g. lock)., to put on (glasses, etc.)., to cover., to burden someone., to apply (insurance)., to turn on (an engine, etc.), to set (a dial, an alarm clock, etc.)., to put an effect (spell, anaesthetic, etc.) on., to hold an emotion for (pity, hope, etc.)., to bind., to pour (or sprinkle, spray, etc.) onto., to argue (in court), to deliberate (in a meeting), to present (e.g. idea to a conference, etc.)., to increase further., to catch (in a trap, etc.)., to set atop., to erect (a makeshift building)., to hold (a play, festival, etc.)., to wager, to bet, to risk, to stake, to gamble., to be partway doing ..., to begin (but not complete) ..., to be about to ...., indicates (verb) is being directed to (someone).
休む	やすむ	to be absent, to take a day off., to rest, to have a break., to go to bed, to (lie down to) sleep, to turn in, to retire., to stop doing some ongoing activity for a time, to suspend business.
近い	ちかい	near, close, short (distance).
太い	ふとい	fat, thick., deep (of a voice)., daring, shameless, brazen., lucky (billiards).
薄い	うすい	thin., pale, light., watery, dilute, sparse., weak (taste, etc.)., slim (probability, etc.), small.
万年筆	まんねんひつ, まんねんぴつ, まんねんふで	fountain pen.
曇り	くもり	cloudiness, cloudy weather, shadow.
灰皿	はいざら	ashtray.
九つ	ここのつ	nine.
乗る	のる	to get on (train, plane, bus, ship, etc.), to get in, to board, to take, to embark., to get on (e.g. a footstool), to step on, to jump on, to sit on, to mount., to reach, to go over, to pass., to follow, to stay (on track), to go with (the times, etc.)., to take part, to participate, to join., to get into the swing (and sing, dance, etc.)., to be deceived, to be taken in., to be carried, to be spread, to be scattered., to stick, to attach, to take, to go on.
飛ぶ	とぶ	to fly, to soar., to jump, to leap, to spring, to bound, to hop.
話す	はなす	to talk, to speak, to converse, to chat., to tell, to explain, to narrate, to mention, to describe, to discuss., to speak (a language).
立つ	たつ	to stand, to rise, to stand up., to find oneself (e.g. in a difficult position)., to depart (on a plane, train, etc.).
茶わん	ちゃわん	rice bowl, tea cup, teacup.
椅子	いす	chair, stool., post, office, position.
撮る	とる	to take (a photo)., to record (video, audio, etc.), to make (a film).
締める	しめる	to tie, to fasten., to total, to sum., to be strict with., to economize, to economise, to cut down on., to salt, to marinate, to pickle, to make sushi adding a mixture of vinegar and salt., to wear (necktie), to put on (necktie).
洗う	あらう	to wash., to investigate.
風呂	ふろ	bath, bathtub., bathroom, bathhouse., room for drying lacquerware., base (wooden joint connecting the blade of a hoe, spade, etc., to the handle).
弱い	よわい	weak, frail, delicate, tender, unskilled, weak (wine).
小さい	ちいさい	small, little, tiny.
辛い	からい	spicy, hot., salty., harsh (criticism), severe (punishment), strict., painful, bitter, difficult, tough.
珈琲	コーヒー, こーひー	coffee.
零	れい, ぜろ, ゼロ	zero, nought.
何故	なぜ, なにゆえ	why, how.
閉まる	しまる	to be shut, to close, to be closed., to be locked., to tighten, to be tightened., to become sober, to become tense.
片仮名	かたかな, カタカナ	katakana, angular Japanese syllabary used primarily for loanwords.
頁	ページ	page.
開ける	あける	to open (a door, etc.), to unwrap (e.g. parcel, package), to unlock., to open (for business, etc.)., to empty, to remove, to make space, to make room., to move out, to clear out., to be away from (e.g. one's house), to leave (temporarily)., to dawn, to grow light., to end (of a period, season)., to begin (of the New Year)., to leave (one's schedule) open, to make time (for)., to make (a hole), to open up (a hole).
他	ほか	other (place, thing, person), the rest., outside, beyond., nothing except, nothing but, nothing apart from, nothing aside from, no choice (but to)., besides..., in addition to....
十日	とおか	the tenth day of the month., ten days.
一日	いちにち, いちじつ, ひとひ, ひとえ	first day of the month., one day.
頃	ころ, ごろ	(approximate) time, around, about, toward., suitable time (or condition)., time of year, season.
開く	あく	to open (e.g. doors)., to open (e.g. business, etc.)., to be empty., to be vacant, to be available, to be free., to be open (e.g. neckline, etc.)., to have been opened (of one's eyes, mouth, etc.)., to come to an end., to open (one's eyes, mouth, etc.)., to have a hole, to form a gap, to have an interval (between events).
朝ご飯	あさごはん	breakfast.
奇麗	きれい	pretty, lovely, beautiful, fair., clean, clear, pure, tidy, neat., completely, entirely.
二十歳	はたち	20 years old.
一日	ついたち, さくじつ, いっぴ	first day of the month.
絵	え	picture, drawing, painting, sketch.
日本語	にほんご, にっぽんご	Japanese (language).
煙草	たばこ, えんそう, けぶりぐさ, けむりぐさ, タバコ	tobacco, cigarettes.
大きな	おおきな	big, large, great.
夕飯	ゆうはん, ゆうめし	evening meal.
何の	どの	which, what (way).
一寸	ちょっと, ちょと, チョット, ちょいと, チョッと	just a minute, short time, just a little., somewhat, easily, readily, rather., (will not) easily., hey!.
飲む	のむ	to drink, to gulp, to swallow, to take (medicine)., to smoke (tobacco)., to engulf, to overwhelm., to keep down, to suppress., to accept (e.g. demand, condition)., to make light of, to conceal.
彼方	あちら, あっち, あち	that way (direction distant from both speaker and listener), over there, yonder., that one (something physically distant from both speaker and listener, or something not visible but known by both speaker and listener), that., that person (someone physically distant from both speaker and listener, or someone not present but known by both speaker and listener)., there (place distant from both speaker and listener), over there, foreign country (esp. a Western nation).
掛かる	かかる	to take (a resource, e.g. time or money)., to hang., to come into view, to arrive., to come under (a contract, a tax)., to start (engines, motors)., to attend, to deal with, to handle., to have started to, to be on the verge of., to overlap (e.g. information in a manual), to cover., to (come) at., to be fastened., to be covered (e.g. with dust, a table-cloth, etc.)., to be caught in., to get a call., to depend on.
ご飯	ごはん	cooked rice., meal.
下さい	ください	please give me., (after te-form of a verb or a noun prefixed with o- or go-) please do for me.
座る	すわる	to sit, to squat., to assume (a position)., to hold steady, to hold still.
重い	おもい	heavy, weighty, massive., heavy (feeling), depressed, gloomy, blue, uneasy., slow, sluggish, lumbering, ponderous, clumsy., important, serious, grave., serious, severe, critical., solid, established, dignified, sensible.
食べる	たべる	to eat., to live on (e.g. a salary), to live off, to subsist on.
青い	あおい	blue, green., pale., unripe, inexperienced.
短い	みじかい	short.
入る	はいる	to enter, to go into., to break into., to join, to enroll., to contain, to hold, to accommodate., to have (an income of)., to get, to receive, to score.
八百屋	やおや	greengrocer.
閉める	しめる	to close, to shut.
遊ぶ	あそぶ, あすぶ	to play, to enjoy oneself, to have a good time., to mess about (with alcohol, gambling, philandery, etc.)., to be idle, to do nothing, to be unused., to go to (for pleasure or for study)., to intentionally throw a ball to lower the batter's concentration.
覚える	おぼえる	to memorize, to memorise, to commit to memory, to learn by heart, to bear in mind, to remember., to learn, to pick up, to acquire., to feel., to think, to regard.
再来年	さらいねん	year after next.
晴れる	はれる	to clear up, to clear away, to be sunny, to stop raining., to refresh (e.g. spirits)., to be cleared (e.g. of a suspicion)., to be dispelled, to be banished.
違う	ちがう	to differ (from), to vary., to not be in the usual condition., to not match the correct (answer, etc.)., to be different from promised., isn't it?, wasn't it?.
花瓶	かびん, はながめ, かへい	(flower) vase.
降る	ふる	to precipitate, to fall (e.g. rain).
消す	けす	to erase, to delete, to cross out., to turn off power., to extinguish, to put out., to bump off.
本棚	ほんだな	bookshelves, bookshelf, bookcase.
要る	いる	to need, to want.
曲がる	まがる	to bend, to curve, to warp, to wind, to twist., to turn., to be awry, to be askew, to be crooked.
始まる	はじまる	to begin, to start, to commence., to happen (again), to begin (anew)., to date (from), to originate (in).
誰か	だれか	someone, somebody.
冷たい	つめたい, つべたい	cold (to the touch), chilly, icy, freezing., coldhearted, unfeeling.
出掛ける	でかける	to go out (e.g. on an excursion or outing), to leave, to depart, to start, to set out., to be about to leave, to be just going out.
何時	いつ	when, how soon.
厚い	あつい	thick, deep, heavy., kind, cordial, hospitable, warm, faithful., serious (of an illness)., abundant.
今晩	こんばん	tonight, this evening.
疲れる	つかれる	to get tired, to tire., to be worn out (e.g. of well used objects).
並ぶ	ならぶ	to line up, to stand in a line., to rival, to match, to equal.
困る	こまる	to be troubled, to be worried, to be bothered, to be embarrassed, to be stumped.
若い	わかい	young.
涼しい	すずしい	cool, refreshing., clear (e.g. eyes), bright., clear, distinct., composed (facial expression), unruffled, unconcerned.
起きる	おきる	to get up, to rise., to wake up, to be awake, to stay awake., to occur (usu. of unfavourable incidents), to happen, to take place.
貸す	かす	to lend, to loan., to rent out, to hire out.
醤油	しょうゆ, しょうゆう, しょゆ, しょゆう	soy sauce, shoyu.
石鹸	せっけん	soap.
可愛い	かわいい, かわゆい	cute, adorable, charming, lovely, pretty., dear, precious, darling, pet., cute little, tiny.
一	いち, ひと, ひ, ひい	one., best., first, foremost., beginning, start., bottom string (on a shamisen, etc.).
鶏肉	けいにく, とりにく	chicken meat.
同じ	おなじ, おんなじ	same, identical, equal, uniform, equivalent, similar, common (origin), changeless, alike., (usu. part of a 'nara' conditional) anyway, anyhow, in either case.
遠い	とおい	far, distant.
吸う	すう	to smoke, to breathe in, to inhale., to suck, to sip, to slurp., to absorb, to soak up., to kiss.
軽い	かるい, かろい	light (i.e. not heavy), feeling light (i.e. offering little resistance, moving easily)., light (i.e. of foot), nimble, agile., non-serious, minor, unimportant, trivial., slight, small, gentle, soft., easy, simple., indiscriminate.
暑い	あつい	hot (weather, etc.), warm.
成る	なる	to become, to get, to grow, to be, to reach, to attain., to result in, to prove to be., to consist of, to be composed of., to succeed, to be complete., to change into, to be exchanged for., to play a role., to be promoted (shogi)., to do ....
答える	こたえる	to answer, to reply.
汚い	きたない	dirty, filthy, foul, unclean., disordered, messy, untidy, poor (e.g. handwriting)., indecent (language, etc.), dirty, vulgar, coarse., dastardly, mean, base, underhanded., stingy, greedy.
見せる	みせる	to show, to display.
此方	こちら, こっち, こち	this way (direction close to the speaker or towards the speaker), this direction., here (place close to the speaker or where the speaker is)., this one (something physically close to the speaker)., I, me, we, us., this person (someone physically close to the speaker and of equal or higher status).
其方	そちら, そっち, そなた, そち	that way (direction distant from the speaker, close to the listener)., there (place distant from the speaker, close to the listener)., that one (something close to the listener)., you, your family, your company., that person (someone close to the listener).
如何	どう, いかが, いか	how, in what way, how about.
パーティ		party.
フィルム		film.
フォーク		fork., folk, folk song., hawk.
Ｙシャツ	ワイシャツ	shirt, business shirt, dress shirt.
何方	どちら, どっち, いずかた, いずち, どち, いずし, なにざま	which way, which direction, where., which one (esp. of two alternatives)., who.
御	ご, お	honourable, honorable.
其れでは	それでは, それじゃ	well then ...., in that situation, in which case.
然し	しかし	however, but.
平仮名	ひらがな	hiragana, cursive Japanese syllabary used primarily for native Japanese words (esp. function words, inflections, etc.).
無くす	なくす	to lose something., to get rid of., to lose someone (wife, child, etc.).
有難うございます	ありがとうございます	thank you.
行く	いく, ゆく	to go, to move (in a direction or towards a specific location), to head (towards), to be transported (towards), to reach., to proceed, to take place., to pass through, to come and go., to walk., to die, to pass away., to do (in a specific way)., to stream, to flow., to continue., to have an orgasm, to come, to cum., to trip, to get high, to have a drug-induced hallucination.
頭	あたま, かしら	head., hair (on one's head)., mind, brains, intellect., leader, chief, boss, captain., top, tip., beginning, start., head, person., top structural component of a kanji.
明後日	あさって, みょうごにち	day after tomorrow.
幾ら	いくら	how much?, how many?., even, even if.
帰る	かえる	to return, to come home, to go home, to go back., to leave., to get home, to get to home plate.
教える	おしえる	to teach, to inform, to instruct.
段々	だんだん	gradually, by degrees., steps, stairs, staircase, terrace.
易しい	やさしい	easy, plain, simple.
危ない	あぶない	dangerous, risky, hazardous, perilous, precarious., in danger, in jeopardy, critical, grave, at risk., uncertain, unreliable, insecure, unsteady, doubtful., close (i.e. a close call), narrow., look out!, watch out!.
消える	きえる	to go out, to vanish, to disappear.
お巡りさん	おまわりさん	police officer.
寒い	さむい, さぶい	cold (e.g. weather)., uninteresting (esp. joke), lame, dull, weak, corny.
一昨日	おととい, おとつい, いっさくじつ	day before yesterday.
黄色い	きいろい	yellow., high-pitched (voice), shrill.
差す	さす	to shine., to be visible., to be tinged with., to rise (of water levels), to flow in., to be felt (i.e. as an emotion), to come over one., to hold up (an umbrella, etc.), to put up, to raise., to extend one's arm straight ahead (in dance)., to insert, to put in., to wear (a sword) in one's belt, to wear at one's side, to carry under one's arm., to insert one's arm under an opponent's arm., to pole (a boat)., to pour, to add (liquid), to serve (drinks)., to put on (lipstick, etc.), to apply, to colour, to dye., to light (a fire), to burn., to shut, to close, to lock, to fasten., to stop in the midst of, to leave undone.
渡る	わたる	to cross over, to go across., to extend, to cover, to range, to span.
暗い	くらい	dark, gloomy., dark (in colour), dull., depressed, dispirited., sorrowful, bitter (as in a dark past)., unclear, unfamiliar, unknown.
習う	ならう	to take lessons in, to be taught, to learn (from a teacher), to study (under a teacher), to get training in.
沢山	たくさん	many, a lot, much.
曇る	くもる	to get cloudy, to cloud over, to become overcast., to cloud up, to fog up, to mist up, to become dim., to be gloomy, to be clouded (expression), to be downcast., to look slightly downward (of a noh mask; indicating sadness, grief, etc.).
色々	いろいろ	various.
飴	あめ	(hard) candy, toffee., rice-sugar, sugar made from the starch of rice, potatoes, etc.., amber, yellowish-brown.
多い	おおい	many, numerous.
脱ぐ	ぬぐ	to take off (clothes, shoes, etc.), to undress.
無い	ない	nonexistent, not being (there)., unpossessed, unowned, not had., unique., indicates negation, inexperience, unnecessariness or impossibility., not ...., to not be..., to have not ....
冊	さつ	counter for books., volume.
死ぬ	しぬ	to die, to pass away., to lose spirit, to lose vigor, to look dead., to cease, to stop.
被る	かぶる, かむる	to put on (one's head), to wear, to have on, to pull over (one's head), to crown (oneself)., to be covered with (dust, snow, etc.), to pour (water, etc.) on oneself, to dash on oneself, to ship water., to bear (e.g. someone's debts, faults, etc.), to take (blame), to assume (responsibility), to shoulder (burden)., to overlap (e.g. sound or color)., to be similar, to be redundant., to be fogged (due to overexposure, etc.)., to close, to come to an end., to get a full house, to sell out.
安い	やすい	cheap, inexpensive., calm, peaceful, quiet.
狭い	せまい	narrow, confined, small.
住む	すむ	to live (of humans), to reside, to inhabit, to dwell, to abide.
枚	まい	counter for flat objects (e.g. sheets of paper).
何処	どこ, いずこ, いずく, いどこ	where, what place., how much (long, far), what extent.
悪い	わるい	bad, poor, inferior., evil, sinful., unprofitable, unbeneficial., at fault, to blame, in the wrong., sorry.
良く	よく	nicely, properly, well, skillfully., frequently, often.
彼処	あそこ, あすこ, かしこ, あしこ, あこ	there (place physically distant from both speaker and listener), over there, that place, yonder., genitals., that far (something psychologically distant from both speaker and listener), that much, that point.
彼の	あの, かの	that (someone or something distant from both speaker and listener, or situation unfamiliar to both speaker and listener).
あのう		say, well, errr ....
彼	あれ, あ	that (indicating something distant from both speaker and listener (in space, time or psychologically), or something understood without naming it directly)., that person (used to refer to one's equals or inferiors)., down there (i.e. one's genitals)., period, menses., hey (expression of surprise, suspicion, etc.), huh?, eh?., that (something mentioned before which is distant psychologically or in terms of time).
お菓子	おかし	confections, sweets, candy.
お願いします	おねがいします	please.
お休みなさい	おやすみなさい	good night.
お兄さん	おにいさん	older brother, elder brother., (vocative) young man, buddy, fella, laddie.
お姉さん	おねえさん	elder sister., (vocative) young lady., miss (referring to a waitress, etc.)., ma'am (used by geisha to refer to their superiors)., older girl (no relation).
お手洗い	おてあらい	toilet, restroom, lavatory, bathroom.
お祖父さん	おじいさん	grandfather., male senior-citizen.
お祖母さん	おばあさん	grandmother., female senior-citizen.
お早うございます	おはようございます	good morning.
お腹	おなか	stomach.
じゃあ		then, well, so, well then., combination of 'de' and 'wa' particles., plain copula.
其処	そこ	there (place relatively near listener)., there (place just mentioned), that place., then (of some incident just spoken of), that (of point just raised).
然して	そして, しかして	and, and then, thus, and now.
其の	その	that (something or someone distant from the speaker, close to the listener; actions of the listener, or ideas expressed or understood by the listener), the., um..., er..., uh....
其れ	それ	that (indicating an item or person near the listener, the action of the listener, or something on their mind), it., that time, then.
其れから	それから	and then, after that.
丈	だけ	only, just, as.
詰らない	つまらない	dull, uninteresting, boring, tedious., insignificant, unimportant, trifling, trivial, worthless., absurd, foolish, silly, stupid., useless, pointless, disappointing.
迚も	とても, とっても	very, awfully, exceedingly., (before a negative form) (not) at all, by no means, simply (cannot).
どう致しまして	どういたしまして	you are welcome, don't mention it, not at all, my pleasure.
何れ	どれ	which (of three or more)., whichever, any., well, now, let me see.
アパート		apartment building, apartment block, apartment house., apartment.
エレベーター		elevator, lift., elevator (aviation).
カップ		cup (drinking vessel, measure, brassiere, prize, etc.).
カメラ		camera.
咖哩	カレー, カリー	curry., rice and curry.
カレンダー		calendar., calender (machine for flattening things).
キロ		kilo-, 10^3., kilogram, kilogramme., kilometre, kilometer., kilo-, 2^10.
瓩	キログラム	kilogram, kilogramme.
粁	キロメートル, キロメイトル	kilometer, kilometre.
ギター		guitar.
クラス		class.
瓦	グラム	gram, gramme.
コート		coat., court (i.e. tennis, basketball, etc.).
コップ		glass (i.e. drinking vessel), tumbler., cop (police officer).
コピー		copy, photocopy., blurb on a book jacket., catch copy.
シャツ		shirt (underwear), undershirt, singlet., shirt (outerwear, esp. dress shirt).
シャワー		shower.
スカート		skirt.
ストーブ		heater (from stove).
スプーン		spoon.
スポーツ		sport, sports.
スリッパ		slipper, slippers.
ズボン		trousers.
セーター		sweater, jumper.
タクシー		taxi.
テーブル		table.
テープ		tape.
テープレコーダー		tape recorder.
テスト		test.
テレビ		television, TV., TV program, TV programme, TV broadcast.
デパート		department store., department.
デモ		demo, demonstration.
トイレ		toilet, restroom, bathroom, lavatory.
ドア		door (Western-style).
ナイフ		knife.
ニュース		news.
ネクタイ		tie, necktie.
ノート		notebook, copy-book, exercise book., note., notebook PC.
ハンカチ		handkerchief.
バス		bus., bath., bass.
バター		butter.
パン		bread, pastries (e.g. croissants), pastry-based products., pan, frying pan., panning (in a film).
プール		(swimming) pool., pool (billiards)., pool (together).
ベッド		bed.
ペン		pen.
ホテル		hotel.
ボールペン		ball-point pen.
釦	ボタン, ぼたん	button.
ポケット		pocket.
ポスト		post, position., postbox, mail box, pillar box., post-.
燐寸	マッチ	match (to light fire with).
米	メートル	metre, meter., meter (i.e. a gauge), gauge.
ラジオ		radio.
レコード		record (e.g. LP)., record (e.g. athletics).
レストラン		restaurant (esp. Western-style).
くらい		approximately, about, around, or so., to (about) the extent that, (almost) enough that, so ... that ..., at least., as ... as ..., like.
為る	する	to do., to cause to become, to make (into), to turn (into)., to serve as, to act as, to work as., to wear (clothes, a facial expression, etc.)., to judge as being, to view as being, to think of as, to treat as, to use as., to decide on, to choose., to be sensed (of a smell, noise, etc.)., to be (in a state, condition, etc.)., to be worth, to cost., to pass (of time), to elapse., verbalizing suffix (applies to nouns noted in this dictionary with the part of speech "vs")., creates a humble verb (after a noun prefixed with "o" or "go")., to be just about to, to be just starting to, to try to, to attempt to.
引く	ひく	to pull., to draw (attention, etc.), to attract (interest, etc.)., to draw back., to draw (a card)., to draw (plan, line, etc.)., to catch (cold)., to play (string instr.)., to look up (e.g. dictionary), to consult., to haul, to pull (vehicles)., to subtract., to ebb, to fade., to descend (from), to inherit (a characteristic)., to quote, to raise (as evidence)., to lay (a cable), to draw (a cable).
奥さん	おくさん	wife, your wife, his wife, married lady, madam.
温い	ぬるい, ぬくい	lukewarm, tepid., lenient.
下	した	below, down, under, younger (e.g. daughter)., bottom., beneath, underneath., just after, right after., inferiority, one's inferior (i.e. one's junior)., trade-in., preliminary, preparatory.
何時も	いつも	always, usually, every time., never (with neg. verb).
何方	どなた	who?.
家	いえ	house, residence, dwelling., family, household., lineage, family name.
家	うち, ち	house, home (one's own)., (one's) family, (one's) household.
鞄	かばん	bag, satchel, briefcase, basket.
貴方	あなた	you (referring to someone of equal or lower status)., dear (what a wife calls a husband).
宜しく	よろしく	well, properly, suitably., best regards, please remember me, please treat me favorably (favourably), please take care of., just like ..., as though one were ...., by all means, of course.
近く	ちかく	near, neighbourhood, neighborhood, vicinity., nearly (i.e. "it took nearly one year"), close to., shortly, soon.
金曜日	きんようび	Friday.
九日	ここのか, ここぬか	the ninth day of the month., nine days.
空	そら	sky, the heavens.
月曜日	げつようび	Monday.
個	こ, コ	counter for articles., counter for military units., individual.
五日	いつか	the fifth day of the month., five days.
ご免ください	ごめんください	may I come in?., please forgive me, I'm sorry.
好き	すき	liking, fondness, love.
此処	ここ	here (place physically close to the speaker, place pointed by the speaker while explaining), this place., these last (followed by a duration noun and a past sentence: time period before the present time of the speaker)., these next ... (followed by a duration noun and a non past sentence: time period after the present time of the speaker), the next ....
今日は	こんにちは, こんちは	hello, good day (daytime greeting).
今晩は	こんばんは	good evening.
左様なら	さようなら	good-bye.
済みません	すみません	excuse me, pardon me, I'm sorry., thank you.
咲く	さく	to bloom.
三日	みっか	the third day of the month., three days.
四日	よっか	fourth day of month., four days.
字引	じびき	dictionary.
次	つぎ	next, following, subsequent., stage, station.
初めて	はじめて	for the first time., only after ... is it ..., only when ... do you ....
所	ところ, とこ	place, spot, scene, site., address., district, area, locality., one's house., point., part., space, room., whereupon, as a result., about to, on the verge of., was just doing, was in the process of doing, have just done, just finished doing.
書く	かく	to write, to compose, to pen., to draw, to paint.
上	うえ	above, up, over, elder (e.g. daughter)., top, summit., surface, on., before, previous., superiority, one's superior (i.e. one's elder)., on top of that, besides, what's more., upon (further inspection, etc.), based on (and occurring after)., matters concerning..., as concerns ...., since (i.e. "for that reason")., suffix indicating higher social standing.
人	じん	-ian (e.g. Italian, etc.) (attaches to name of country to denote nationality), -er (e.g. performer, etc.) (attaches to name of occupation)., (usu. in compound words) man, person, people.
吹く	ふく	to blow (wind, etc.), to play a wind instrument., to emit, to spout., to whistle., to laugh, to burst into laughter., to smelt, to mint., to brag, to talk big.
水曜日	すいようび	Wednesday.
生まれる	うまれる	to be born.
先	さき	previous, prior, former, some time ago, preceding., point (e.g. pencil), tip, end, nozzle., head (of a line), front., ahead, the other side., the future, hereafter., destination., the other party.
前	まえ	ago, before (some event), previously, (minutes) to (the hour)., in front (of), before (e.g. the house)., head (of a line), front (e.g. of a bus), fore part., in the presence of., helping, portion., privates, private parts.
頂きます	いただきます	expression of gratitude before meals.
達	たち	pluralizing suffix (esp. for people & animals; formerly honorific).
誕生日	たんじょうび	birthday.
弾く	ひく	to play (piano, guitar).
置く	おく	to put, to place., to leave (behind)., to do something in advance (usu. following te-form verb).
着く	つく	to arrive at, to reach., to sit on, to sit at (e.g. the table).
中	なか	inside, in., among, within., center (centre), middle., during, while.
丁度	ちょうど	just, right, exactly.
度	ど	degree (angle, temperature, scale, etc.)., counter for occurrences and times., strength (of alcohol).
土曜日	どようび	Saturday.
働く	はたらく	to work, to labor, to labour., to function, to operate, to be effective, to work (i.e. ... works), to come into play., to commit (e.g. a crime), to perpetrate, to do, to act, to practise, to practice., to be conjugated.
乍ら	ながら	while, during, as., while, although, though, despite, in spite of, notwithstanding., all, both., as (i.e. "as always", "as long ago"), in (i.e. "in tears").
二日	ふつか	second day of the month., two days.
賑やか	にぎやか	bustling, busy, lively.
日曜日	にちようび	Sunday.
入れる	いれる	to put in, to let in, to take in, to bring in, to insert, to set (a jewel, etc.), to ink in (e.g. a tattoo)., to admit, to accept, to employ, to hire., to accept, to comply, to grant, to adopt (a policy, etc.), to take (advice, etc.), to listen to, to pay attention to., to include., to pay (one's rent, etc.)., to cast (a vote)., to make (tea, coffee, etc.)., to turn on (a switch, etc.)., to send (a fax), to call.
如何して	どうして	why?, for what reason, how, in what way, for what purpose, what for.
八日	ようか	the eighth day of the month., eight days.
煩い	うるさい, ウルサイ	noisy, loud., annoying, troublesome, tiresome, persistent, importunate., fussy, finicky, picky, particular, nagging, fastidious, bossy., shut up!, be quiet!.
美味しい	おいしい, オイシイ	delicious, tasty, sweet.
不味い	まずい, マズイ, マズい	unappetising, unappetizing, unpleasant (taste, appearance, situation)., unskillful, unskilful, bungling, clumsy., ugly, homely, plain, unattractive., awkward, untimely, inopportune, unfavorable, unwise.
風	かぜ	wind, breeze, draught, draft., manner, behaviour, behavior., cold, influenza.
物	もの, もん	thing, object, article, stuff, substance., one's things, possessions, property, belongings., things, something, anything, everything, nothing., quality., reason, the way of things., used to emphasize emotion, judgment, etc., used to indicate a common occurrence in the past (after a verb in past tense), used to indicate a general tendency, used to indicate something that should happen., item classified as ..., item related to ..., work of ...., cause of ..., cause for ...., somehow, somewhat, for some reason., really, truly.
分	ふん	minute., fun (one tenth of a monme, 5.787 grains).
並べる	ならべる	to line up, to set up, to arrange in a line., to enumerate, to itemize., to be equal (to), to compare well (with), to be as good (as).
歩く	あるく	to walk.
方	かた	direction, way., person, lady, gentleman., method of, manner of, way of., care of ..., person in charge of ..., side (e.g. "on my mother's side").
忘れる	わすれる	to forget, to leave carelessly, to be forgetful of, to forget about, to forget (an article).
本	ほん	book, volume, script., this, present., main, head., real, regular., counter for long cylindrical things, counter for films, TV shows, etc., counter for goals, home runs, etc., counter for telephone calls.
磨く	みがく	to polish, to shine, to brush (e.g. teeth)., to refine, to improve.
未だ	まだ, いまだ	as yet, hitherto, only, still., not yet (with negative verb)., more, besides., unfinished, incomplete, not yet finished with.
鳴く	なく	to sing (bird)., to bark, to purr, to make sound (animal).
木曜日	もくようび	Thursday.
葉書	はがき, ハガキ	postcard., memo, note, card.
六日	むいか, むゆか, むよか	sixth day of the month., six days.
居る	いる	to be (of animate objects), to exist., to stay., (after the -te form of a verb) verb indicating continuing action or state (i.e. to be ..ing, to have been ..ing).
七日	なのか, なぬか	the seventh day of the month., seven days.
真っ直ぐ	まっすぐ	straight (ahead), direct, upright, erect., straightforward, honest, frank.
人	ひと, ヒト	man, person., human being, mankind, people., human (Homo sapiens), humans as a species., character, personality., man of talent, true man., another person, other people, others., adult.
側	がわ, かわ	side (of something, or taking someone's side), part., (watch) case.
店	みせ	store, shop, establishment.
等	など	et cetera, etc., and the like, and so forth., or something., the likes of.
此の	この	this (something or someone close to the speaker (including the speaker), or ideas expressed by the speaker).
八つ	やっつ, やつ	eight.
万	まん, よろず	10,000, ten thousand., myriad., everything, all.
六つ	むっつ, むつ	six.
聞く	きく	to hear., to listen (e.g. to music)., to ask, to enquire, to query., to learn of, to hear about., to follow (advice), to comply with., to smell (esp. incense), to sample fragrance.
二十日	はつか	twentieth day of the month., twenty days.
履く	はく	to put on (or wear) lower-body clothing (i.e. pants, skirt, etc.), to put on (or wear) footwear., to affix a sword to one's hip., to affix a bowstring to a bow.
点ける	つける	to turn on, to switch on, to light up.
然うして	そうして	and, like that.
中	ちゅう	medium, average, middle., moderation., middle school., China., in, out of (e.g. three out of ten people)., during (a certain time when one did or is doing something), under (construction, etc.), while.
此れ	これ	this (indicating an item near the speaker, the action of the speaker, or the current topic)., this person (usu. indicating someone in one's in-group)., now.
ずつ		apiece, each., at a time, piecemeal.
背	せ	back, spine., reverse, rear side., height., ridge (of a mountain).
人	にん, たり, り	counter for people., (usu. in compound words) person.
いらっしゃいませ		welcome (in shops, etc.).
ええ		yes, that is correct, right., um, errr., huh?., grrr, gah, Must I?., good.
こんな		such (about something or someone close to the speaker (including the speaker), or about ideas expressed by the speaker), like this.
さあ		come, come now, come along, go on, hurry up., well, who knows, I don't know..., uh, hmm., well now, let's see, there we go, all right., about that, you see.
さん		Mr., Mrs., Miss, Ms., -san., makes words more polite (usu. in fixed expressions).
そう		so, really, seeming., (after masu stem and adj-stem) appearing that, seeming that, looking like, having the appearance of.
では		then, well, so, well then.
でも		but, however, though, nevertheless, still, yet, even so., even., however, no matter how, even if, even though., ... or something., either ... or ..., neither ... nor ...., pseudo-, quack, in-name-only., for lack of anything better to do.
どうも		thanks., much (thanks), very (sorry), quite (regret)., quite, really, mostly., somehow., in spite of oneself, no matter how hard one may try (one is unable to) (with negative verb), no matter how hard one may try not to (one ends up doing) (with positive verb, esp. -shimau)., greetings, hello, goodbye.
どんな		what, what kind of., (with -temo, demo, etc.) any(body, thing, means, etc.).
はい		yes, that is correct., understood, I see, OK, okay., present, here., giddy-up, giddap.
もう		now, soon, shortly, before long, presently., already, yet, by now, (not) anymore., further, more, again, another, the other., interjection used to strengthen expression of an emotion (often exasperation).
もしもし		hello (e.g. on phone)., excuse me! (when calling out to someone).
もっと		(some) more, even more, longer, further.
遣る	やる	to send, to dispatch, to despatch., to put, to move, to turn (one's head, glance, etc.)., to give (esp. to someone of equal or lower status), to let have, to present, to bestow, to confer., to make (a vehicle) go faster., to do, to undertake, to perform, to play (a game), to study., to run (a business), to keep, to be engaged in, to practice (law, medicine, etc.), to practise., to have (food, drink, etc.), to eat, to drink, to smoke., to hold (a performance), to perform, to show., to ease (one's mind)., to harm, to injure, to kill., to have sex with., to live, to get by, to get along., to do ... completely., to do ... broadly, to do ... to a great distance., to do ... for (someone of equal or lower status), to do ... to (sometimes with negative nuance)., to make active efforts to ....
ゆっくり		slowly, at ease, restful.
より		from, out of, since, at., than., other than, except, but., more.
イクラ		salted salmon roe (i.e. individual mature eggs).
ペット		pet., trumpet.
ラジカセ		radio-cassette player.
どうぞ		please, kindly, I beg of you., by all means, feel free, you are welcome., here you are.
か		indicates a question (sometimes rhetorical)., or, whether or not., some- (e.g. something, someone)., indicates doubt, uncertainty, etc.., emphatic prefix., suffix forming adjectives or adverbs.
さよなら		good-bye.
ない		not., emphatic suffix.
こちらこそ		it is I who should say so.
ご馳走様でした	ごちそうさまでした	That was a delicious meal (said after meals), What a wonderful meal.
ラジオカセット		radio-cassette, tape recorder.
一月	ひとつき, いちげつ	one month.
御免なさい	ごめんなさい	I beg your pardon, excuse me.
お皿	おさら	plate, dish.
失礼しました	しつれいしました	excuse me, I'm sorry.
お酒	おさけ, ごしゅ	alcohol, sake.
直ぐに	すぐに	instantly, immediately.
お弁当	おべんとう	bento (Japanese box lunch).
嗚呼	ああ, アー	Ah!, Oh!, Alas!., Yes, Indeed, That is correct., Hey!, Yo!., Uh huh, Yeah yeah, Right, Gotcha.
晩御飯	ばんごはん	dinner, evening meal.
昼ご飯	ひるごはん	lunch, midday meal.
初めまして	はじめまして	How do you do?, I am glad to meet you.
がる		to show signs of being, to feel, to think., to behave as if one were, to pretend, to act as if., to want, to desire, to be anxious to, to be eager to.
イイ		Iran-Iraq.
もう一度	もういちど	once more, again.
赤	あか	red, crimson, scarlet., red-containing colour (e.g. brown, pink, orange)., Red (i.e. communist)., red light., red ink (i.e. in finance or proof-reading), (in) the red., complete, total, perfect, obvious., copper.
時	じ	hour, o'clock., (specified) time, when ..., during ....
リッパー		ripper., ripsaw.
番	ばん	number (in a series)., (one's) turn., watch, guard, lookout., bout, match (sumo).
屋	や	(something) shop., somebody who sells (something) or works as (something)., somebody with a (certain) personality trait., house., roof.
日	にち	Sunday., day (of the month)., counter for days., Japan.
年	ねん	year (e.g. AD)., counter for years.
月	がつ	month (of the year), used after number or question word (e.g. nan or nani).
ではまた		see you later (used in casual correspondence and conversation), goodbye, sincerely.
小さな	ちいさな	small, little, tiny.
どうも有難うございます	どうもありがとうございます	thank you very much.
タブン		tabun (nerve gas).
お風呂	おふろ	bath.
どう		whoa (command used to stop a horse, etc.).
伯父さん	おじさん, オジサン	uncle., old man, mister (vocative)., manybar goatfish (Parupeneus multifasciatus).
伯母さん	おばさん	aunt.
お元気ですか	おげんきですか	how are you?.
失礼します	しつれいします	excuse me.
